Date,LTP,Open,High,Low,Quantity,Turnover,Change
3/25/2011,135,133,135,132,2560,342820,-2
3/27/2011,134,135,135,134,2110,284040,1
3/28/2011,130,134,134,130,1288,169336,4
3/29/2011,127,130,129,127,1390,178760,3
3/30/2011,129,127,129,125,1261,161332,-2
3/31/2011,132,129,134,127,1475,191490,-3
4/04/2011,131,132,132,126,2927,378740,1
4/05/2011,128,131,130,126,1828,236055,3
4/06/2011,131,128,131,125,5221,672814,-3
4/07/2011,128,131,130,126,825,105890,3
4/10/2011,128,128,128,126,1531,194797,0
4/11/2011,128,128,129,126,3030,388690,0
4/13/2011,127,128,127,127,60,7620,1
4/17/2011,125,127,127,125,1650,207460,2
4/18/2011,122,125,126,121,2651,329486,3
4/19/2011,126,122,128,120,866,107182,-4
4/20/2011,126,126,128,125,3022,381832,0
4/21/2011,124,126,128,123,2040,255070,2
4/25/2011,122,124,124,122,3265,403300,2
4/26/2011,122,122,122,122,70,8540,0
4/27/2011,121,122,125,119,3367,406887,1
4/28/2011,124,121,125,122,2299,283012,-3
5/02/2011,123,124,123,119,2030,245810,1
5/03/2011,127,123,127,123,1120,140240,-4
5/04/2011,126,127,127,124,2484,312736,1
5/05/2011,125,126,126,124,931,116584,1
5/08/2011,124,125,131,121,4485,563061,1
5/09/2011,124,124,124,122,840,102720,0
5/10/2011,125,124,126,124,1013,126395,-1
5/11/2011,129,125,129,126,400,50780,-4
5/12/2011,130,129,131,127,741,95643,-1
5/15/2011,131,130,132,130,3412,448352,-1
5/16/2011,138,131,138,130,3382,445266,-7
5/18/2011,133,138,136,128,1703,223392,5
5/19/2011,131,133,135,127,2307,304895,2
5/22/2011,131,131,131,128,1918,248828,0
5/23/2011,130,131,133,128,4281,560579,1
5/24/2011,132,130,132,128,2801,362950,-2
5/25/2011,128,132,130,128,690,89350,4
5/26/2011,129,128,129,128,590,76010,-1
5/30/2011,130,129,132,128,1283,167103,-1
5/31/2011,132,130,132,126,1623,209534,-2
6/01/2011,128,132,131,128,1013,130927,4
6/02/2011,129,128,130,128,3753,483975,-1
6/05/2011,126,129,129,126,930,118940,3
6/06/2011,122,126,127,122,816,101444,4
6/07/2011,118,122,122,118,2242,268962,4
6/08/2011,118,118,118,116,270,31540,0
6/09/2011,120,118,120,114,1656,190891,-2
6/12/2011,120,120,122,118,1031,123239,0
6/13/2011,117,120,121,117,1601,189667,3
6/14/2011,117,117,117,115,640,74480,0
6/15/2011,121,117,121,115,1069,125961,-4
6/16/2011,124,121,124,121,541,66591,-3
6/19/2011,130,124,130,126,523,66758,-6
6/20/2011,130,124,130,126,523,66758,-6
6/21/2011,136,134,139,136,632,86886,-2
6/23/2011,147,136,147,138,661,94663,-11
6/26/2011,147,147,151,147,670,100360,0
6/29/2011,140,147,140,140,220,30800,7
7/04/2011,126,140,138,126,2659,348714,14
7/05/2011,126,126,126,120,1253,153713,0
7/06/2011,125,126,127,124,1475,184107,1
7/07/2011,125,125,128,124,953,119940,0
7/10/2011,125,125,127,125,1940,244210,0
7/11/2011,127,125,127,122,2172,267740,-2
7/12/2011,127,127,127,124,4396,549060,0
7/13/2011,131,127,133,129,1322,173152,-4
7/14/2011,130,131,133,130,911,118613,1
7/18/2011,132,130,132,132,60,7920,-2
7/19/2011,132,132,134,128,1450,192560,0
7/20/2011,132,132,134,132,2761,364712,0
7/21/2011,132,132,132,129,1540,201150,0
7/24/2011,130,132,132,127,3830,491580,2
7/25/2011,129,130,129,126,1130,145160,1
7/26/2011,127,129,127,125,400,50240,2
7/27/2011,132,127,132,125,1932,249358,-5
7/28/2011,128,132,132,128,1146,149697,4
7/31/2011,125,128,129,122,2491,312693,3
8/01/2011,126,125,126,123,1030,128640,-1
8/02/2011,125,126,126,125,2112,264385,1
8/03/2011,123,125,126,123,1425,177475,2
8/04/2011,126,123,126,124,110,13740,-3
8/07/2011,125,126,126,123,685,85519,1
8/08/2011,125,125,127,124,2076,259460,0
8/09/2011,123,125,126,123,3006,371852,2
8/10/2011,125,123,125,123,1838,228763,-2
8/11/2011,123,125,125,121,1547,190621,2
8/15/2011,127,123,129,121,2387,300965,-4
8/16/2011,126,127,127,125,827,104729,1
8/17/2011,130,126,130,126,2452,313314,-4
8/18/2011,128,130,128,127,772,98506,2
8/22/2011,127,128,127,127,1000,127000,1
8/23/2011,127,127,127,124,6027,757268,0
8/24/2011,126,127,127,125,1351,169857,1
8/25/2011,126,126,126,122,1662,205859,0
8/28/2011,126,126,127,126,281,35507,0
8/29/2011,124,126,126,123,435,54250,2
8/30/2011,122,124,124,122,490,60280,2
9/01/2011,125,122,126,123,1452,180419,-3
9/04/2011,125,125,125,120,1402,171368,0
9/05/2011,120,125,123,118,2152,259129,5
9/06/2011,121,120,121,118,3800,457550,-1
9/07/2011,120,121,122,119,3400,411001,1
9/08/2011,121,120,121,119,1120,134020,-1
9/12/2011,119,121,121,119,1934,231304,2
9/13/2011,118,119,118,114,1498,174718,1
9/14/2011,117,118,119,116,1880,221098,1
9/15/2011,120,117,120,118,845,101020,-3
9/18/2011,116,120,120,115,992,116181,4
9/19/2011,117,116,118,116,403,47168,-1
9/20/2011,118,117,120,118,571,68039,-1
9/21/2011,117,118,117,117,683,79911,1
9/22/2011,118,117,120,116,1230,145130,-1
9/25/2011,120,118,120,116,2124,249661,-2
9/26/2011,120,120,120,115,1155,136110,0
9/27/2011,118,120,119,118,1650,195440,2
9/29/2011,118,118,119,117,1062,125124,0
10/02/2011,117,118,117,115,320,37210,1
10/10/2011,120,117,120,116,781,92063,-3
10/12/2011,118,120,118,115,974,113308,2
10/13/2011,118,118,119,116,3345,391615,0
10/16/2011,117,118,119,116,1400,164296,1
10/17/2011,117,117,117,115,1261,147132,0
10/18/2011,116,117,117,115,991,115077,1
10/19/2011,117,116,117,117,820,95940,-1
10/20/2011,116,117,118,114,956,111213,1
10/23/2011,115,116,117,115,1908,221180,1
10/24/2011,116,115,118,115,1190,138420,-1
10/25/2011,119,116,119,114,1244,146192,-3
10/30/2011,120,119,121,120,9320,1127600,-1
10/31/2011,119,120,119,116,1262,148740,1
11/02/2011,129,119,129,121,110,13870,-10
11/03/2011,133,129,135,131,5625,739865,-4
11/06/2011,120,133,131,120,3883,468994,13
11/08/2011,119,120,120,117,2100,247629,1
11/09/2011,118,119,120,118,1182,139809,1
11/10/2011,119,118,119,118,3122,368686,-1
11/13/2011,120,119,120,118,1164,139094,-1
11/14/2011,122,120,122,114,2691,314662,-2
11/15/2011,119,122,121,118,1157,138490,3
11/16/2011,120,119,120,118,1400,166860,-1
11/17/2011,118,120,120,118,734,86866,2
11/20/2011,118,118,118,115,2545,297845,0
11/21/2011,118,118,118,117,1461,172188,0
11/22/2011,117,118,118,117,1141,133767,1
11/23/2011,117,117,118,117,410,48010,0
11/24/2011,117,117,119,114,1499,175671,0
11/27/2011,119,117,119,116,2513,295234,-2
11/28/2011,118,119,118,117,61,7168,1
11/29/2011,156,160,163,155,2778,445990,4
11/29/2011,156,160,163,155,2778,445990,4
11/29/2011,156,160,163,155,2778,445990,4
12/05/2011,121,125,123,121,20,2440,4
12/06/2011,119,121,119,119,30,3570,2
12/07/2011,114,119,117,114,5809,668048,5
12/08/2011,117,114,117,114,3872,445802,-3
12/11/2011,115,117,115,113,1249,142286,2
12/12/2011,115,115,115,114,1087,123949,0
12/13/2011,114,115,115,113,2102,238809,1
12/14/2011,114,114,116,113,1225,139440,0
12/15/2011,114,114,115,113,2866,327977,0
12/18/2011,114,114,115,112,651,73614,0
12/19/2011,113,114,116,113,1228,141948,1
12/20/2011,113,113,115,113,1011,114544,0
12/21/2011,116,113,116,113,1397,159698,-3
12/22/2011,116,116,116,114,210,24120,0
12/26/2011,113,116,114,112,1702,191866,3
12/27/2011,114,113,114,113,1405,159578,-1
12/28/2011,113,114,113,113,250,28250,1
12/29/2011,115,113,116,112,1699,193297,-2
1/01/2012,114,115,115,113,1111,125973,1
1/02/2012,118,114,118,115,551,64227,-4
1/03/2012,115,118,116,114,490,56130,3
1/04/2012,114,115,115,113,3220,369040,1
1/05/2012,113,114,114,112,775,87595,1
1/08/2012,114,113,115,113,3240,369120,-1
1/09/2012,111,114,113,111,1710,190718,3
1/10/2012,112,113,114,112,549,62007,1
1/11/2012,112,112,112,111,2477,277012,0
1/12/2012,112,112,112,110,3102,344864,0
1/16/2012,111,112,112,111,1049,116985,1
1/17/2012,113,111,114,110,866,96445,-2
1/18/2012,118,113,118,114,2190,253740,-5
1/19/2012,117,118,117,115,411,47745,1
1/22/2012,117,117,118,115,4484,522708,0
1/23/2012,112,117,115,111,1650,187270,5
1/25/2012,114,112,114,111,1170,130710,-2
1/26/2012,112,114,114,110,1060,118750,2
1/29/2012,112,112,114,111,4200,473960,0
1/31/2012,110,112,114,110,2291,254352,2
2/01/2012,111,110,113,110,1833,203887,-1
2/02/2012,111,111,113,111,3946,442100,0
2/05/2012,110,111,111,109,1611,176945,1
2/06/2012,111,110,111,110,992,109391,-1
2/07/2012,110,111,110,107,2091,227290,1
2/08/2012,110,110,110,109,386,42300,0
2/09/2012,109,110,110,109,920,100990,1
2/12/2012,109,109,109,108,1309,142115,0
2/13/2012,108,109,111,107,1992,216906,1
2/14/2012,109,108,110,107,1961,211790,-1
2/15/2012,111,109,111,110,276,30410,-2
2/16/2012,108,111,109,107,550,59100,3
2/21/2012,109,108,109,108,631,68289,-1
2/23/2012,109,109,109,107,1230,132700,0
2/26/2012,107,109,109,105,2747,293109,2
2/27/2012,108,107,109,107,1285,139322,-1
2/28/2012,109,108,110,107,2204,238530,-1
2/29/2012,108,109,109,108,1030,111630,1
3/01/2012,108,108,109,107,2300,249002,0
3/04/2012,109,108,109,104,1451,155189,-1
3/05/2012,107,109,109,107,460,49660,2
3/06/2012,105,107,107,105,2124,225526,2
3/11/2012,106,105,106,105,754,79584,-1
3/12/2012,106,106,107,102,1022,106572,0
3/13/2012,104,106,106,104,1321,137985,2
3/14/2012,103,104,105,103,793,82513,1
3/15/2012,103,103,103,101,842,85504,0
3/18/2012,103,103,103,101,1003,102758,0
3/19/2012,102,103,105,102,311,32483,1
3/20/2012,101,102,103,101,4107,416910,1
3/21/2012,104,101,106,101,1257,129261,-3
3/25/2012,106,104,106,102,920,95370,-2
3/26/2012,107,106,107,103,2082,221133,-1
3/27/2012,103,107,105,102,270,27830,4
3/28/2012,106,103,106,104,1615,169040,-3
3/29/2012,105,106,108,105,1395,148120,1
4/01/2012,106,105,106,105,1762,185480,-1
4/02/2012,105,106,106,104,1275,133865,1
4/03/2012,106,105,106,106,680,72080,-1
4/04/2012,105,106,106,105,3550,376180,1
4/05/2012,106,105,106,105,680,71490,-1
4/08/2012,106,106,106,105,1051,111356,0
4/09/2012,106,106,107,105,921,97896,0
4/10/2012,106,106,106,104,1313,138808,0
4/11/2012,107,106,110,107,2180,233710,-1
4/12/2012,114,107,114,108,683,75303,-7
4/15/2012,123,114,124,116,2514,301404,-9
4/16/2012,135,123,135,125,833,109229,-12
4/17/2012,130,135,133,130,1789,235440,5
4/18/2012,124,130,128,120,3301,408208,6
4/19/2012,122,124,128,120,4668,576322,2
4/22/2012,123,122,124,122,1560,192010,-1
4/24/2012,129,123,129,125,100,12700,-6
4/25/2012,135,129,135,135,70,9450,-6
4/26/2012,148,135,148,137,8831,1274199,-13
4/29/2012,150,148,159,141,8923,1328959,-2
4/30/2012,140,150,153,135,5694,813164,10
5/02/2012,128,140,140,128,980,129220,12
5/03/2012,132,128,132,130,241,31510,-4
5/07/2012,134,132,134,134,183,24522,-2
5/08/2012,142,134,142,136,2332,321736,-8
5/09/2012,142,142,148,133,7062,996321,0
5/10/2012,139,142,142,129,11243,1556324,3
5/13/2012,132,139,137,130,3133,415883,7
5/14/2012,125,132,130,121,5092,635763,7
5/15/2012,137,125,137,127,696,92212,-12
5/16/2012,139,137,139,139,150,20850,-2
5/17/2012,141,139,147,141,6469,933133,-2
5/20/2012,139,141,142,134,6548,909268,2
5/21/2012,139,139,145,138,3222,451680,0
5/22/2012,143,139,143,133,8963,1252988,-4
5/23/2012,133,143,141,133,905,123926,10
5/24/2012,143,133,143,133,7754,1084486,-10
5/27/2012,148,143,153,140,6836,998739,-5
5/29/2012,134,148,146,134,3959,531126,14
5/30/2012,121,134,132,121,4480,557981,13
5/31/2012,128,121,128,119,1231,151903,-7
6/03/2012,140,128,140,125,1647,216171,-12
6/04/2012,133,140,141,130,3705,505703,7
6/05/2012,133,133,135,131,2968,396926,0
6/06/2012,126,133,131,125,1331,169046,7
6/07/2012,131,126,134,122,2120,272620,-5
6/10/2012,138,131,140,133,8139,1121181,-7
6/11/2012,140,138,142,136,4583,639992,-2
6/12/2012,140,140,142,139,4983,700086,0
6/13/2012,141,140,146,138,8518,1212358,-1
6/14/2012,136,141,139,133,1912,261330,5
6/17/2012,134,136,136,128,2426,319452,2
6/18/2012,133,134,133,130,2589,339342,1
6/19/2012,132,133,133,131,1549,205401,1
6/20/2012,134,132,136,132,1361,181782,-2
6/21/2012,136,134,137,135,1170,159205,-2
6/25/2012,140,136,140,133,1760,240479,-4
6/26/2012,136,140,138,134,2036,276849,4
6/27/2012,140,136,140,132,2422,335010,-4
6/28/2012,140,140,142,139,2876,405460,0
7/01/2012,142,140,142,140,3643,511666,-2
7/02/2012,141,142,145,140,3256,461850,1
7/03/2012,141,141,141,140,880,123560,0
7/04/2012,146,141,146,140,3868,552017,-5
7/05/2012,145,146,145,142,3056,440599,1
7/08/2012,144,145,148,143,2338,339189,1
7/09/2012,148,144,150,144,3893,580402,-4
7/10/2012,150,148,153,148,3747,562915,-2
7/11/2012,152,150,152,148,3631,547862,-2
7/12/2012,151,152,156,149,3977,603820,1
7/15/2012,156,151,156,151,1722,264957,-5
7/16/2012,162,156,162,150,12898,2056829,-6
7/17/2012,171,162,175,161,12061,2022192,-9
7/18/2012,186,171,186,170,8985,1579465,-15
7/19/2012,198,186,198,176,21519,3981231,-12
7/22/2012,192,198,200,187,19689,3862081,6
7/23/2012,190,192,198,189,13375,2595472,2
7/24/2012,190,190,190,181,7364,1373111,0
7/25/2012,184,190,187,181,10548,1941772,6
7/26/2012,177,184,181,175,4910,865984,7
7/29/2012,166,177,174,161,4932,816039,11
7/30/2012,171,166,172,163,7450,1264553,-5
7/31/2012,176,171,182,168,4757,830988,-5
8/01/2012,180,176,182,174,6479,1164471,-4
8/05/2012,181,180,184,178,4178,756789,-1
8/06/2012,181,181,183,180,5741,1041584,0
8/07/2012,176,181,184,174,4255,766179,5
8/08/2012,179,176,179,170,6744,1193276,-3
8/12/2012,171,179,179,167,3111,526901,8
8/13/2012,168,171,168,160,3464,565610,3
8/14/2012,166,168,168,165,1990,331980,2
8/15/2012,163,166,166,161,4533,745798,3
8/16/2012,170,163,176,166,5649,963562,-7
8/19/2012,173,170,175,170,5601,963445,-3
8/21/2012,166,173,175,164,5218,872531,7
8/22/2012,165,166,167,161,4219,694872,1
8/23/2012,165,165,167,162,3162,518253,0
8/26/2012,173,165,174,165,10162,1747933,-8
8/27/2012,175,173,177,174,3340,585390,-2
8/28/2012,177,175,180,173,7405,1315960,-2
8/29/2012,176,177,176,173,6758,1185158,1
8/30/2012,171,176,173,170,1905,327625,5
9/02/2012,171,171,172,170,2866,489510,0
9/03/2012,171,171,175,171,4178,719780,0
9/04/2012,170,171,170,168,5642,957458,1
9/05/2012,170,170,172,170,2370,403420,0
9/06/2012,170,170,171,170,7102,1207410,0
9/09/2012,171,170,172,170,5013,856792,-1
9/10/2012,172,171,172,166,5097,870547,-1
9/11/2012,172,172,172,170,1662,284433,0
9/12/2012,171,172,172,171,3222,552452,1
9/13/2012,173,171,173,171,2968,512518,-2
9/16/2012,175,173,175,172,3274,568210,-2
9/17/2012,177,175,177,173,3239,566717,-2
9/18/2012,180,177,183,175,2338,418066,-3
9/19/2012,182,180,182,177,10568,1907189,-2
9/20/2012,180,182,181,179,8013,1444364,2
9/23/2012,180,180,182,177,7991,1441392,0
9/24/2012,177,180,180,177,160,28680,3
9/25/2012,175,177,176,172,4295,744936,2
9/26/2012,177,175,177,172,6587,1160788,-2
9/30/2012,175,174,175,173,5747,1003775,-1
10/01/2012,175,175,176,173,4962,869140,0
10/01/2012,175,175,176,173,4962,869140,0
10/02/2012,175,175,176,175,2888,505550,0
10/03/2012,176,175,176,172,2684,468831,-1
10/04/2012,175,176,177,175,2620,458704,1
10/07/2012,175,175,178,175,3211,567262,0
10/08/2012,175,175,176,175,3157,552856,0
10/09/2012,175,175,176,175,5229,917062,0
10/10/2012,176,175,181,175,3367,596925,-1
10/11/2012,175,176,177,175,7164,1258070,1
10/14/2012,177,175,178,175,3698,652719,-2
10/15/2012,176,177,177,175,2449,432540,1
10/17/2012,178,176,178,178,517,92026,-2
10/18/2012,178,178,179,176,1405,248955,0
10/30/2012,183,178,183,176,1294,231559,-5
10/31/2012,182,183,189,180,2858,530873,1
11/01/2012,182,182,182,180,2402,435712,0
11/04/2012,186,182,190,179,3923,724571,-4
11/05/2012,188,186,191,180,2610,490577,-2
11/06/2012,188,188,190,187,3708,702020,0
11/07/2012,195,188,199,184,4246,817138,-7
11/08/2012,194,195,201,194,3508,694262,1
11/11/2012,194,194,200,191,2797,546479,0
11/12/2012,196,194,196,192,3161,614689,-2
11/18/2012,202,196,209,195,4897,994614,-6
11/20/2012,204,202,210,199,3585,733012,-2
11/21/2012,205,204,208,200,7505,1525135,-1
11/22/2012,205,205,206,200,12951,2639478,0
11/25/2012,211,205,216,206,7730,1616875,-6
11/26/2012,208,211,209,203,6583,1360314,3
11/27/2012,203,208,209,203,3234,669924,5
11/28/2012,208,203,211,200,5510,1140060,-5
11/29/2012,207,208,208,206,2261,468543,1
12/02/2012,201,207,207,200,4800,979797,6
12/03/2012,203,201,206,200,4633,940840,-2
12/04/2012,204,203,210,203,3519,724455,-1
12/05/2012,208,204,212,205,5953,1242677,-4
12/06/2012,206,208,208,206,1830,378272,2
12/09/2012,204,206,205,200,5198,1049273,2
12/10/2012,201,204,202,200,4919,990072,3
12/11/2012,205,201,205,201,3414,692828,-4
12/12/2012,203,205,205,201,4574,930981,2
12/13/2012,208,203,208,204,3290,677622,-5
12/16/2012,215,208,224,207,5244,1122454,-7
12/17/2012,218,215,220,215,3328,722115,-3
12/18/2012,215,218,216,203,5273,1109014,3
12/19/2012,216,215,218,211,8116,1754927,-1
12/20/2012,209,216,218,209,5727,1225914,7
12/23/2012,213,209,217,205,7171,1521313,-4
12/24/2012,228,213,230,213,3500,761899,-15
12/26/2012,238,228,240,228,6219,1457520,-10
12/27/2012,250,238,255,231,4877,1180004,-12
12/31/2012,240,250,249,233,14630,3535419,10
1/01/2013,238,240,241,233,7961,1886847,2
1/02/2013,242,238,242,233,5628,1338716,-4
1/03/2013,246,242,250,235,10342,2525509,-4
1/06/2013,241,246,245,238,6384,1537292,5
1/07/2013,241,241,241,237,6744,1618316,0
1/08/2013,239,241,244,234,7156,1703991,2
1/09/2013,238,239,240,233,3658,859760,1
1/10/2013,243,238,243,234,3936,926659,-5
1/13/2013,240,243,241,235,5314,1270879,3
1/15/2013,264,240,264,240,14770,3792351,-24
1/16/2013,270,264,287,252,19323,5252055,-6
1/17/2013,254,270,271,250,5818,1487094,16
1/20/2013,247,254,251,242,2655,650337,7
1/21/2013,251,247,255,244,6088,1518158,-4
1/22/2013,261,251,265,250,7109,1844536,-10
1/23/2013,260,261,262,257,4532,1179857,1
1/24/2013,252,260,260,252,4722,1213666,8
1/27/2013,250,252,253,241,3268,814458,2
1/28/2013,243,250,249,242,6464,1584602,7
1/30/2013,242,243,243,240,5603,1349446,1
1/31/2013,236,242,246,233,2997,708013,6
2/03/2013,241,236,248,236,4519,1095421,-5
2/04/2013,242,241,242,236,2909,699241,-1
2/05/2013,242,242,243,240,2382,576632,0
2/06/2013,238,242,242,236,2204,527551,4
2/07/2013,240,238,240,237,2011,478839,-2
2/10/2013,244,240,244,238,4273,1022327,-4
2/12/2013,250,244,255,244,1951,482759,-6
2/13/2013,245,250,255,242,1862,459360,5
2/14/2013,251,245,253,245,4871,1220880,-6
2/17/2013,276,251,276,256,450,121050,-25
2/19/2013,260,276,281,257,6905,1818761,16
2/20/2013,250,260,255,250,5135,1287536,10
2/21/2013,250,250,255,244,3237,806090,0
2/24/2013,250,250,251,244,2131,528781,0
2/25/2013,255,250,255,246,2352,588900,-5
2/26/2013,250,255,260,245,2202,550690,5
2/27/2013,250,250,250,245,3682,910972,0
2/28/2013,250,250,252,249,9283,2327783,0
3/03/2013,250,250,255,248,7283,1830465,0
3/04/2013,250,250,255,250,2021,509122,0
3/05/2013,252,250,254,249,1333,336037,-2
3/06/2013,256,252,257,250,5661,1440343,-4
3/07/2013,260,256,266,252,8671,2265826,-4
3/11/2013,260,260,263,257,5405,1405374,0
3/13/2013,270,260,275,259,5687,1493131,-10
3/14/2013,265,270,275,262,9300,2477564,5
3/17/2013,260,265,265,255,5629,1451955,5
3/18/2013,256,260,257,252,4336,1106916,4
3/19/2013,260,256,261,255,5473,1413615,-4
3/20/2013,253,260,256,252,1903,483472,7
3/21/2013,250,253,252,245,3174,793134,3
3/24/2013,245,250,247,242,2999,731283,5
3/25/2013,248,245,250,241,3862,946034,-3
3/27/2013,247,248,249,245,2307,569636,1
3/28/2013,246,247,248,243,3297,812378,1
3/31/2013,240,246,246,238,7670,1846622,6
4/01/2013,242,240,245,235,6103,1444771,-2
4/02/2013,246,242,246,241,5576,1356730,-4
4/03/2013,245,246,250,245,3462,857395,1
4/04/2013,244,245,245,242,1588,387606,1
4/07/2013,246,244,246,244,2378,582346,-2
4/08/2013,244,246,248,244,1805,442849,2
4/09/2013,245,244,247,243,2150,527330,-1
4/11/2013,245,245,247,245,2923,717670,0
4/15/2013,241,245,245,240,1467,354299,4
4/16/2013,241,241,244,240,2711,651780,0
4/17/2013,243,241,246,238,2336,563436,-2
4/18/2013,240,243,243,240,2324,559820,3
4/21/2013,235,240,238,235,3138,742406,5
4/22/2013,235,235,235,227,3428,791277,0
4/23/2013,238,235,239,235,2531,599433,-3
4/25/2013,230,238,234,225,1360,311840,8
4/28/2013,226,230,229,226,1623,367960,4
4/29/2013,227,226,232,226,2263,512829,-1
4/30/2013,230,227,230,225,3425,775719,-3
5/02/2013,221,230,230,218,2410,535462,9
5/05/2013,211,221,227,211,2917,632915,10
5/06/2013,203,211,207,201,2272,463908,8
5/07/2013,215,203,218,203,1989,419838,-12
5/08/2013,215,215,217,212,1152,245944,0
5/09/2013,210,215,212,207,480,100140,5
5/12/2013,216,210,220,210,2755,597834,-6
5/13/2013,221,216,221,217,1666,364355,-5
5/14/2013,222,221,223,219,2285,505106,-1
5/15/2013,234,222,234,220,1507,342258,-12
5/16/2013,232,234,232,230,862,198720,2
5/19/2013,222,232,228,222,1205,270695,10
5/20/2013,223,222,226,218,1461,321313,-1
5/21/2013,235,223,239,225,8468,1943122,-12
5/22/2013,232,235,239,230,2936,684321,3
5/23/2013,218,232,228,218,2170,478160,14
5/26/2013,221,218,224,217,2433,534693,-3
5/27/2013,225,221,228,220,1307,291896,-4
5/28/2013,225,225,231,222,1841,415405,0
5/30/2013,226,225,228,224,3965,895230,-1
6/02/2013,223,226,230,222,2959,663898,3
6/03/2013,225,223,225,222,2001,449855,-2
6/04/2013,225,225,230,224,5887,1333015,0
6/05/2013,225,225,226,223,3773,848790,0
6/06/2013,221,225,229,220,5457,1210170,4
6/09/2013,220,221,223,218,1275,280850,1
6/10/2013,215,220,221,214,1674,364055,5
6/11/2013,213,215,217,213,4959,1064592,2
6/12/2013,213,213,215,209,938,199288,0
6/13/2013,206,213,210,205,2734,567220,7
6/16/2013,205,206,214,205,3116,644132,1
6/17/2013,206,205,206,201,3177,648719,-1
6/18/2013,203,206,205,202,3775,767682,3
6/19/2013,204,203,204,200,2193,443437,-1
6/20/2013,202,204,204,200,2914,586023,2
6/23/2013,202,202,205,200,3944,793113,0
6/24/2013,204,202,204,200,2863,578614,-2
6/25/2013,212,204,212,201,1591,325869,-8
6/26/2013,210,212,214,209,2267,476574,2
6/27/2013,204,210,209,202,2462,506206,6
6/30/2013,204,204,204,200,4074,826362,0
7/01/2013,204,204,204,201,8440,1715347,0
7/02/2013,214,204,214,202,6663,1386542,-10
7/03/2013,217,214,223,214,8503,1846323,-3
7/04/2013,216,217,218,212,2654,570056,1
7/07/2013,212,216,213,208,1944,409642,4
7/08/2013,213,212,213,210,1314,278717,-1
7/09/2013,216,213,216,212,4180,896995,-3
7/10/2013,215,216,217,215,906,195796,1
7/11/2013,211,215,217,210,1952,412900,4
7/14/2013,213,211,213,211,849,180152,-2
7/15/2013,212,213,216,211,520,110330,1
7/16/2013,212,212,213,208,1405,295776,0
7/17/2013,218,212,218,209,833,176111,-6
7/18/2013,215,218,218,211,3565,760658,3
7/21/2013,220,215,222,211,1576,344059,-5
7/22/2013,219,220,219,213,3960,857015,1
7/23/2013,220,219,220,215,2380,522130,-1
7/24/2013,220,219,220,216,3875,845100,-1
7/25/2013,220,220,221,217,6133,1346153,0
7/28/2013,219,220,220,217,2271,495460,1
7/29/2013,220,219,222,218,6445,1417338,-1
7/30/2013,222,220,226,213,4366,967312,-2
7/31/2013,227,222,239,220,5674,1319038,-5
8/01/2013,233,227,234,228,3874,894640,-6
8/04/2013,235,233,239,230,6786,1565735,-2
8/05/2013,244,235,244,230,16970,3996457,-9
8/06/2013,240,244,244,232,8059,1929139,4
8/07/2013,250,240,255,239,14766,3668196,-10
8/08/2013,256,250,256,247,10429,2645586,-6
8/11/2013,258,256,260,246,6243,1601607,-2
8/12/2013,258,258,258,254,5404,1382829,0
8/13/2013,255,258,260,255,12121,3107958,3
8/14/2013,265,255,275,255,22278,5876172,-10
8/15/2013,274,265,275,262,17518,4682661,-9
8/18/2013,289,274,293,271,8762,2496818,-15
8/19/2013,295,289,299,284,13094,3825734,-6
8/20/2013,290,295,295,285,14268,4129463,5
8/25/2013,275,290,290,271,9229,2559665,15
8/26/2013,265,275,280,265,10512,2853463,10
8/27/2013,269,265,273,266,5993,1615807,-4
8/29/2013,270,269,275,261,10781,2920690,-1
9/01/2013,273,270,278,266,10315,2795826,-3
9/02/2013,273,273,273,269,4607,1247979,0
9/03/2013,270,273,273,265,9705,2619325,3
9/04/2013,268,270,274,265,5881,1581356,2
9/05/2013,270,268,270,263,4619,1240671,-2
9/08/2013,268,270,270,266,1430,383452,2
9/09/2013,265,268,268,260,3761,990215,3
9/10/2013,260,265,263,256,3506,912022,5
9/11/2013,256,260,260,255,3560,913664,4
9/12/2013,256,256,259,255,2297,589964,0
9/15/2013,251,256,255,247,1705,425223,5
9/16/2013,243,251,249,240,3105,759329,8
9/17/2013,249,243,250,239,4190,1030774,-6
9/19/2013,251,249,253,242,7230,1794525,-2
9/22/2013,248,251,250,243,3598,891274,3
9/23/2013,256,248,256,240,4366,1093319,-8
9/24/2013,255,256,260,249,3569,904154,1
9/25/2013,252,255,260,250,2342,595174,3
9/26/2013,250,252,255,248,2947,739707,2
9/29/2013,250,250,254,248,5593,1397377,0
9/30/2013,253,250,255,251,4048,1020083,-3
10/01/2013,257,253,258,250,6780,1726362,-4
10/02/2013,265,257,265,255,4507,1174185,-8
10/03/2013,261,265,268,255,5989,1565000,4
10/06/2013,268,261,271,260,6298,1679891,-7
10/07/2013,268,268,272,265,6554,1752440,0
10/09/2013,274,272,280,268,10880,2986516,-2
10/10/2013,287,274,287,274,9084,2543741,-13
10/17/2013,281,287,293,280,3422,971556,6
10/20/2013,288,281,292,272,12323,3530867,-7
10/21/2013,281,288,286,281,5261,1493206,7
10/22/2013,280,281,284,276,2882,804126,1
10/23/2013,279,280,279,275,6589,1823788,1
10/24/2013,271,279,277,266,8658,2361256,8
10/27/2013,270,271,270,265,6644,1773173,1
10/28/2013,266,270,269,260,7712,2055026,4
10/29/2013,268,266,270,266,5113,1372281,-2
10/30/2013,270,268,271,263,3999,1074211,-2
10/31/2013,271,270,275,270,4946,1349234,-1
11/06/2013,270,271,270,266,3065,819162,1
11/07/2013,270,270,272,265,2913,783807,0
11/11/2013,270,265,271,263,2943,786371,-5
11/12/2013,282,270,288,270,2751,770058,-12
11/13/2013,285,282,290,281,13696,3908379,-3
11/14/2013,290,285,290,280,7095,2016131,-5
11/21/2013,306,290,306,295,1316,401056,-16
11/24/2013,324,306,336,315,21647,7102843,-18
11/25/2013,314,324,326,305,13105,4072777,10
11/26/2013,321,314,329,308,28272,9106933,-7
11/27/2013,340,321,342,321,36076,12017076,-19
11/28/2013,342,340,342,334,21680,7342274,-2
12/01/2013,376,342,376,341,23763,8678552,-34
12/02/2013,405,376,412,360,20977,8333188,-29
12/03/2013,400,405,404,389,19402,7700605,5
12/04/2013,402,400,425,392,12389,5056887,-2
12/05/2013,400,402,428,385,21081,8531937,2
12/08/2013,395,400,401,390,16688,6607316,5
12/09/2013,396,395,405,383,26882,10709798,-1
12/10/2013,400,396,405,391,28690,11496761,-4
12/11/2013,410,400,412,393,18473,7444488,-10
12/12/2013,406,409,420,404,17759,7270362,3
12/15/2013,446,406,446,405,20003,8387373,-40
12/16/2013,490,446,490,444,20965,9876974,-44
12/18/2013,485,490,518,485,29053,14533077,5
12/19/2013,493,485,500,475,39462,19287968,-8
12/22/2013,480,490,490,464,19387,9322438,10
12/23/2013,469,472,475,456,33400,15494694,3
12/24/2013,469,469,484,451,29712,13932330,0
12/26/2013,471,469,499,460,15787,7496050,-2
12/29/2013,465,471,475,450,22999,10658221,6
12/31/2013,460,465,468,455,25659,11833095,5
1/01/2014,439,460,455,432,15862,6954305,21
1/02/2014,462,439,462,416,28467,12539546,-23
1/05/2014,468,462,475,441,65735,30288296,-6
1/06/2014,470,468,474,452,25538,11891111,-2
1/07/2014,473,470,473,460,22161,10397910,-3
1/08/2014,491,473,497,470,38768,18856015,-18
1/09/2014,484,491,490,471,20109,9707296,7
1/12/2014,486,484,497,482,24734,12126000,-2
1/13/2014,494,486,494,480,19617,9539420,-8
1/14/2014,501,494,501,489,32504,16167668,-7
1/16/2014,490,501,499,481,19341,9507699,11
1/19/2014,495,490,495,473,29053,14135093,-5
1/20/2014,500,495,519,490,81646,41133902,-5
1/21/2014,488,500,499,485,11260,5548725,12
1/22/2014,478,488,487,472,13817,6560366,10
1/23/2014,480,478,484,469,13779,6598289,-2
1/26/2014,503,480,522,480,40298,20371358,-23
1/27/2014,490,503,504,486,9937,4893569,13
1/28/2014,499,490,500,476,26031,12812248,-9
1/29/2014,503,499,508,495,29804,14948839,-4
2/02/2014,490,503,500,485,8622,4222674,13
2/03/2014,499,490,499,475,16945,8159916,-9
2/04/2014,499,499,499,481,14068,6914480,0
2/06/2014,497,492,501,490,18213,9039773,-5
2/09/2014,500,497,501,488,31751,15848924,-3
2/10/2014,520,500,550,515,52878,28379587,-20
2/11/2014,518,520,521,510,29068,14978823,2
2/12/2014,515,518,515,500,10260,5225358,3
2/13/2014,509,515,518,504,14908,7588708,6
2/16/2014,500,509,507,490,12363,6140653,9
2/17/2014,497,500,503,490,10000,4985741,3
2/18/2014,500,497,502,490,14557,7274455,-3
2/20/2014,506,500,510,493,12477,6285058,-6
2/23/2014,510,506,520,502,16883,8625372,-4
2/24/2014,510,510,521,506,10633,5455405,0
2/25/2014,510,510,510,492,8159,4056577,0
2/26/2014,507,510,510,490,11856,5953703,3
3/03/2014,500,507,500,482,11330,5588614,7
3/04/2014,490,500,494,475,12645,6121482,10
3/05/2014,491,490,495,485,13670,6701152,-1
3/06/2014,485,491,492,480,8096,3949166,6
3/09/2014,477,485,485,476,12131,5814888,8
3/10/2014,480,477,480,467,11578,5457255,-3
3/11/2014,466,480,473,466,5775,2712645,14
3/12/2014,468,466,468,456,5270,2410519,-2
3/13/2014,470,468,471,458,6624,3091316,-2
3/13/2014,470,468,471,458,6624,3091316,-2
3/17/2014,460,470,465,456,5748,2645091,10
3/18/2014,455,460,457,443,9587,4307964,5
3/19/2014,480,455,480,446,10946,5102732,-25
3/20/2014,466,480,478,466,8516,4008312,14
3/23/2014,483,466,483,458,8169,3790999,-17
3/24/2014,507,483,510,475,21201,10555473,-24
3/25/2014,490,507,500,475,29739,14409354,17
3/26/2014,528,490,528,490,60736,30711330,-38
3/27/2014,499,528,538,490,20209,10155615,29
3/31/2014,490,499,492,480,5218,2532600,9
4/01/2014,494,490,494,487,3932,1927934,-4
4/02/2014,489,494,494,485,11115,5450211,5
4/03/2014,484,489,490,480,3927,1909320,5
4/06/2014,481,484,490,480,8848,4280413,3
4/07/2014,480,481,483,473,5197,2489076,1
4/09/2014,479,480,479,474,5534,2641891,1
4/10/2014,480,479,483,480,3389,1629028,-1
4/13/2014,485,480,485,475,5766,2760663,-5
4/15/2014,477,485,480,475,8445,4038532,8
4/16/2014,478,477,478,472,5706,2710690,-1
4/17/2014,476,478,479,472,11560,5492372,2
4/20/2014,470,476,476,465,7619,3569533,6
4/21/2014,467,470,471,462,4512,2098816,3
4/22/2014,484,467,484,464,3658,1716191,-17
4/23/2014,480,484,484,475,6040,2896503,4
4/27/2014,486,480,495,479,19082,9251327,-6
4/28/2014,482,486,485,477,17521,8447946,4
4/29/2014,465,482,485,465,17504,8328232,17
4/30/2014,484,465,490,460,38545,18407064,-19
5/04/2014,485,484,485,485,146,70810,-1
5/06/2014,480,485,480,458,5111,2390588,5
5/07/2014,465,480,485,465,3621,1723446,15
5/08/2014,462,465,465,451,3062,1411016,3
5/11/2014,451,462,462,446,2232,1005475,11
5/12/2014,447,451,453,442,6393,2858303,4
5/13/2014,452,447,460,440,3367,1527250,-5
5/15/2014,450,452,453,446,1498,672591,2
5/15/2014,450,452,453,446,1498,672591,2
5/18/2014,438,450,449,433,2406,1062455,12
5/19/2014,441,438,445,435,3738,1648612,-3
5/20/2014,440,441,442,436,1380,604137,1
5/21/2014,439,440,442,436,1436,630316,1
5/22/2014,441,439,445,437,3420,1506284,-2
5/25/2014,440,441,451,440,1964,874085,1
5/26/2014,439,440,448,436,2068,916313,1
5/27/2014,442,439,443,438,2651,1168679,-3
5/28/2014,455,442,459,441,3465,1555696,-13
6/01/2014,449,455,454,442,3419,1534885,6
6/02/2014,460,449,460,441,5675,2559270,-11
6/03/2014,465,460,483,455,3237,1497446,-5
6/04/2014,450,465,456,450,4933,2231099,15
6/05/2014,451,450,455,441,1460,655013,-1
6/08/2014,445,451,452,442,4810,2137728,6
6/09/2014,442,445,447,442,3135,1390085,3
6/10/2014,451,442,460,440,6762,3048601,-9
6/11/2014,459,451,472,442,7845,3618724,-8
6/12/2014,456,459,468,450,5318,2449340,3
6/15/2014,498,456,498,456,21646,10384789,-42
6/16/2014,504,498,511,485,17798,8894533,-6
6/17/2014,504,504,511,485,13316,6679205,0
6/17/2014,504,504,511,485,13316,6679205,0
6/18/2014,500,504,506,498,5595,2815179,4
6/19/2014,497,500,500,495,4887,2433073,3
6/23/2014,492,497,499,490,2822,1392972,5
6/24/2014,486,492,493,473,4915,2379604,6
6/25/2014,490,486,495,481,5342,2611158,-4
6/26/2014,490,490,495,486,2294,1124885,0
6/29/2014,535,490,535,494,6659,3352126,-45
6/30/2014,535,535,539,510,17816,9248469,0
7/01/2014,530,535,536,515,16496,8688752,5
7/02/2014,526,530,532,520,8711,4581490,4
7/03/2014,540,526,540,511,10454,5471823,-14
7/06/2014,550,540,550,535,10936,5934234,-10
7/07/2014,571,550,571,540,23528,12913417,-21
7/08/2014,628,571,628,575,75326,47099142,-57
7/09/2014,660,628,690,630,64933,43299474,-32
7/10/2014,677,660,690,645,53832,35530679,-17
7/13/2014,698,677,739,677,41709,29179671,-21
7/14/2014,690,698,725,687,41992,29488397,8
7/15/2014,690,690,693,680,13822,9495058,0
7/16/2014,756,690,756,682,15232,10654212,-66
7/17/2014,729,756,742,700,20796,14870226,27
7/20/2014,726,729,770,715,17347,12664584,3
7/21/2014,740,726,740,700,23797,17135329,-14
7/22/2014,715,740,729,700,26067,18395942,25
7/23/2014,710,715,711,698,19797,13946533,5
7/24/2014,703,710,709,694,18897,13278013,7
7/27/2014,699,703,700,690,19175,13359885,4
7/28/2014,695,699,696,686,11965,8266627,4
7/30/2014,680,695,700,670,18615,12729507,15
7/31/2014,671,680,685,666,17974,12129488,9
8/03/2014,659,671,662,650,14283,9369036,12
8/04/2014,650,659,656,641,16927,10936168,9
8/05/2014,657,650,670,648,19507,12914583,-7
8/06/2014,650,657,660,649,19442,12733444,7
8/07/2014,655,650,668,635,27587,17792836,-5
8/12/2014,645,655,649,630,7449,4790514,10
8/13/2014,660,645,660,633,13102,8449188,-15
8/14/2014,657,660,670,647,15244,10054548,3
8/18/2014,612,657,644,595,37244,22612552,45
8/19/2014,610,612,620,596,17808,10869120,2
8/20/2014,605,610,610,588,19673,11856208,5
8/21/2014,600,605,609,580,12597,7501131,5
8/24/2014,600,600,607,586,12176,7224524,0
8/25/2014,559,600,588,548,13049,7367250,41
8/26/2014,532,559,590,527,13423,7398733,27
8/27/2014,559,532,585,540,13712,7637563,-27
8/28/2014,555,559,581,555,9333,5290522,4
8/31/2014,544,555,555,529,7186,3881419,11
9/01/2014,540,544,540,524,8096,4263430,4
9/03/2014,534,540,550,531,6177,3338441,6
9/04/2014,516,534,528,514,13269,6900500,18
9/07/2014,477,516,513,477,8707,4224592,39
9/09/2014,510,477,514,480,6261,3123354,-33
9/10/2014,515,510,550,502,17200,9003879,-5
9/11/2014,510,515,515,494,5116,2564786,5
9/14/2014,501,510,507,495,11790,5894531,9
9/15/2014,495,501,500,490,4559,2263865,6
9/16/2014,500,495,500,493,5664,2813054,-5
9/17/2014,491,500,501,491,2141,1059526,9
9/18/2014,500,491,500,485,4308,2113234,-9
9/21/2014,473,500,491,472,4876,2330048,27
9/22/2014,463,473,478,450,4694,2150250,10
9/23/2014,509,463,509,472,1603,812465,-46
9/24/2014,533,509,555,509,27922,14918155,-24
9/28/2014,533,533,535,520,5441,2872819,0
9/29/2014,549,533,549,526,2590,1383477,-16
9/30/2014,522,549,545,522,4135,2203088,27
10/08/2014,520,522,520,507,1950,1004294,2
10/09/2014,515,520,520,514,4332,2232742,5
10/12/2014,499,515,519,494,3534,1775044,16
10/13/2014,496,499,501,490,6363,3163546,3
10/14/2014,500,496,505,496,2216,1115048,-4
10/15/2014,508,500,510,500,3468,1751854,-8
10/16/2014,512,508,515,500,2026,1036190,-4
10/20/2014,512,524,515,504,1855,943601,12
10/21/2014,506,512,517,506,1623,825062,6
10/22/2014,505,506,514,495,2166,1085421,1
10/26/2014,501,505,501,495,318,158551,4
10/27/2014,508,501,508,500,826,414552,-7
10/28/2014,503,508,507,496,3103,1559251,5
10/30/2014,496,503,502,496,3239,1615458,7
11/02/2014,487,496,488,484,3479,1691461,9
11/03/2014,478,487,490,476,2984,1438935,9
11/04/2014,480,478,480,461,4283,2036039,-2
11/05/2014,490,480,493,477,3198,1561916,-10
11/06/2014,486,490,490,481,4774,2310227,4
11/09/2014,470,486,482,470,4361,2066075,16
11/10/2014,469,470,471,459,7137,3301463,1
11/11/2014,470,469,470,443,2460,1127792,-1
11/12/2014,470,470,477,462,3095,1456430,0
11/13/2014,463,470,479,455,5215,2419866,7
11/16/2014,455,463,463,455,2659,1216890,8
11/17/2014,430,455,453,430,5025,2222843,25
11/18/2014,448,430,449,415,5593,2436446,-18
11/19/2014,457,448,466,440,1602,725958,-9
11/20/2014,457,457,460,449,3097,1415268,0
11/23/2014,480,457,485,457,5920,2802147,-23
11/24/2014,465,480,475,461,1129,527558,15
11/25/2014,457,465,465,457,71,32695,8
11/30/2014,445,457,457,441,1452,645427,12
12/01/2014,443,445,448,439,1733,765978,2
12/02/2014,453,443,453,435,1108,490210,-10
12/03/2014,455,453,467,447,2153,981696,-2
12/04/2014,464,455,469,460,2277,1053864,-9
12/07/2014,452,464,458,448,1718,778573,12
12/08/2014,448,452,450,443,1290,576619,4
12/09/2014,446,448,450,442,2366,1055494,2
12/11/2014,469,470,479,457,4644,2144460,1
12/14/2014,490,469,493,474,3724,1791711,-21
12/15/2014,497,490,505,481,4393,2164203,-7
12/16/2014,492,497,494,470,5232,2561451,5
12/17/2014,485,492,488,479,3200,1541419,7
12/18/2014,480,485,480,465,2212,1042527,5
12/21/2014,464,480,475,461,3044,1412599,16
12/22/2014,473,464,473,452,4523,2091099,-9
12/23/2014,467,473,470,447,2357,1085223,6
12/24/2014,470,467,470,458,3183,1469000,-3
12/28/2014,484,470,484,470,3257,1544943,-14
12/28/2014,484,470,484,470,3257,1544943,-14
12/29/2014,475,484,484,466,2105,1003216,9
12/31/2014,476,475,490,464,2969,1398316,-1
1/01/2015,479,476,485,470,2695,1283385,-3
1/04/2015,478,479,481,474,1201,572959,1
1/05/2015,487,478,487,471,1739,828237,-9
1/06/2015,475,487,480,466,3920,1855816,12
1/07/2015,476,475,476,467,3541,1665797,-1
1/08/2015,473,476,480,472,2511,1192029,3
1/11/2015,484,473,484,465,3451,1634939,-11
1/12/2015,473,484,479,468,3521,1662570,11
1/13/2015,475,473,475,466,1012,478410,-2
1/14/2015,484,475,489,467,11042,5227331,-9
1/18/2015,475,484,485,473,5160,2457433,9
1/19/2015,487,475,499,480,7796,3815845,-12
1/20/2015,478,487,489,474,10113,4855761,9
1/22/2015,473,478,477,470,1265,600389,5
1/25/2015,475,473,483,466,2889,1376546,-2
1/26/2015,481,475,484,470,5767,2756099,-6
1/27/2015,503,481,510,478,13660,6777883,-22
1/28/2015,509,503,513,498,15503,7844801,-6
1/29/2015,500,509,512,495,10005,5006801,9
2/01/2015,493,500,496,491,4653,2293868,7
2/02/2015,487,493,494,485,3667,1790141,6
2/03/2015,483,487,490,472,2126,1022403,4
2/04/2015,480,483,485,475,1946,934257,3
2/05/2015,473,480,489,471,2868,1359038,7
2/08/2015,475,473,476,471,2025,961031,-2
2/09/2015,479,475,484,470,6337,3022364,-4
2/10/2015,475,479,475,463,3543,1667238,4
2/11/2015,476,475,480,470,3776,1793976,-1
2/12/2015,482,476,485,475,5980,2867563,-6
2/15/2015,477,482,482,476,1086,518101,5
2/16/2015,479,477,479,472,4307,2045393,-2
2/16/2015,479,477,479,472,4307,2045393,-2
2/18/2015,474,479,479,472,2807,1332903,5
2/22/2015,464,474,472,464,3088,1442825,10
2/23/2015,464,464,465,456,3374,1556568,0
2/24/2015,465,464,465,460,3018,1399450,-1
2/25/2015,470,465,471,459,2152,1006176,-5
2/26/2015,475,470,475,460,2405,1117678,-5
3/01/2015,480,475,480,470,1184,563346,-5
3/02/2015,480,480,495,475,1111,538538,0
3/03/2015,483,480,484,471,1590,760544,-3
3/04/2015,478,483,492,476,2209,1070845,5
3/09/2015,497,478,504,485,8858,4363621,-19
3/10/2015,481,497,490,472,1061,516270,16
3/11/2015,477,481,485,477,1618,776848,4
3/12/2015,475,477,490,470,1710,821008,2
3/15/2015,475,475,480,471,2644,1253119,0
3/16/2015,471,475,475,467,1607,754534,4
3/17/2015,471,471,473,467,731,343263,0
3/18/2015,472,471,472,466,1901,893189,-1
3/19/2015,480,472,480,470,1882,889894,-8
3/22/2015,467,480,476,464,6630,3104974,13
3/23/2015,469,467,470,463,4993,2323706,-2
3/24/2015,467,469,469,464,1251,582689,2
3/25/2015,470,467,470,459,797,369900,-3
3/26/2015,476,470,476,463,966,450516,-6
3/29/2015,469,476,470,469,531,249540,7
3/30/2015,459,469,469,451,3598,1648978,10
3/31/2015,461,459,465,458,1282,591842,-2
4/01/2015,464,461,464,454,2590,1193443,-3
4/02/2015,465,464,465,455,3444,1570932,-1
4/05/2015,455,465,471,452,1330,609170,10
4/06/2015,450,455,460,446,3678,1651428,5
4/07/2015,450,450,451,446,2372,1064202,0
4/08/2015,458,450,464,449,2164,977352,-8
4/09/2015,471,458,471,451,7084,3217233,-13
4/12/2015,479,471,482,468,4345,2055726,-8
4/13/2015,472,479,472,461,4158,1942976,7
4/15/2015,474,472,475,455,13284,6136508,-2
4/16/2015,468,474,468,455,8979,4145565,6
4/19/2015,436,437,437,429,820,355050,1
4/20/2015,436,436,439,434,1363,594229,0
4/21/2015,439,436,439,431,1312,569615,-3
4/22/2015,440,439,440,435,619,269707,-1
4/23/2015,432,440,434,430,1563,674415,8
5/24/2015,392,432,424,392,90,36080,40
5/25/2015,365,392,385,360,844,307401,27
5/26/2015,397,365,397,370,1215,466395,-32
5/27/2015,376,397,390,376,230,87810,21
5/28/2015,390,376,393,380,2330,901410,-14
5/31/2015,397,390,402,392,1141,455848,-7
6/01/2015,400,397,404,390,2353,937623,-3
6/02/2015,400,400,402,400,181,72480,0
6/03/2015,432,400,432,402,1581,662618,-32
6/04/2015,420,432,440,420,2566,1100750,12
6/07/2015,430,420,435,425,5611,2408058,-10
6/08/2015,430,430,438,425,1959,842943,0
6/08/2015,430,430,438,425,1959,842943,0
6/08/2015,430,430,438,425,1959,842943,0
6/09/2015,448,430,463,438,3888,1753306,-18
6/10/2015,438,448,440,432,880,381800,10
6/11/2015,425,438,432,422,2209,941044,13
6/14/2015,413,425,420,413,2431,1013256,12
6/15/2015,421,413,427,407,1505,629122,-8
6/16/2015,426,421,426,418,1298,544264,-5
6/17/2015,423,426,426,418,1700,720030,3
6/18/2015,416,423,422,412,873,362996,7
6/21/2015,415,416,416,413,1001,415603,1
6/22/2015,415,415,420,410,1380,571866,0
6/23/2015,420,415,423,415,7897,3292563,-5
6/24/2015,414,420,425,414,1269,529878,6
6/25/2015,419,414,420,417,833,348643,-5
6/28/2015,420,419,420,415,2180,910700,-1
6/29/2015,420,420,420,406,8930,3669790,0
6/30/2015,415,420,415,406,6613,2708936,5
7/01/2015,410,415,410,408,572,233930,5
7/02/2015,405,410,408,403,4059,1643141,5
7/05/2015,417,405,419,408,1564,646616,-12
7/06/2015,404,417,417,403,330,134060,13
7/07/2015,405,404,410,404,6448,2614217,-1
7/08/2015,408,405,409,406,2073,843825,-3
7/09/2015,410,408,416,410,401,165640,-2
7/12/2015,411,410,412,405,5083,2078989,-1
7/13/2015,409,411,410,409,1242,508699,2
7/14/2015,410,409,414,406,3414,1399073,-1
7/15/2015,415,410,418,408,2601,1075295,-5
7/16/2015,432,415,432,416,391,163902,-17
7/22/2015,440,432,442,421,7356,3155266,-8
7/23/2015,465,440,465,435,7731,3451191,-25
7/26/2015,511,465,511,474,140,70600,-46
7/27/2015,498,511,521,476,8007,3888936,13
7/28/2015,480,498,489,480,682,328922,18
7/29/2015,467,480,471,467,120,56320,13
7/30/2015,450,467,465,450,3973,1815435,17
8/02/2015,446,450,449,445,558,249171,4
8/03/2015,457,446,458,440,3667,1649736,-11
8/04/2015,441,457,460,439,7651,3383326,16
8/05/2015,452,441,459,437,6625,2937510,-11
8/06/2015,463,452,465,455,8242,3792897,-11
8/09/2015,469,463,469,450,9306,4284284,-6
8/10/2015,479,469,488,470,8260,3946984,-10
8/11/2015,455,479,470,452,2244,1040914,24
8/12/2015,445,455,450,436,4305,1912728,10
8/13/2015,444,445,459,438,8463,3815927,1
8/16/2015,441,444,456,441,15570,7003978,3
8/17/2015,485,441,485,449,14033,6783465,-44
8/18/2015,518,485,518,494,17564,8882141,-33
8/18/2015,518,485,518,494,17564,8882141,-33
8/19/2015,528,518,528,510,4816,2481868,-10
8/20/2015,525,528,548,525,5070,2747398,3
8/23/2015,506,525,516,505,8354,4266993,19
8/24/2015,506,506,509,505,2386,1208981,0
8/25/2015,515,506,515,496,3076,1540334,-9
8/26/2015,505,515,506,505,1300,656700,10
8/27/2015,500,505,505,500,1382,691410,5
8/31/2015,500,500,503,496,3126,1560900,0
9/01/2015,495,500,500,493,6425,3195841,5
9/02/2015,486,495,486,486,1000,486000,9
9/03/2015,465,486,478,465,760,360690,21
9/06/2015,480,465,485,474,1710,823782,-15
9/07/2015,497,480,497,475,2252,1091608,-17
9/08/2015,488,497,496,488,651,322088,9
9/09/2015,480,488,480,480,41,19680,8
9/10/2015,479,480,489,472,7097,3424204,1
9/13/2015,500,479,500,480,9190,4422736,-21
9/14/2015,500,500,511,492,4489,2263296,0
9/15/2015,495,500,505,486,1356,672126,5
9/16/2015,487,495,490,486,1186,578936,8
9/17/2015,480,487,488,475,5292,2541780,7
9/22/2015,456,480,471,456,9991,4642437,24
9/23/2015,465,456,474,460,9252,4268830,-9
9/24/2015,460,465,461,456,956,439860,5
9/28/2015,450,460,454,446,1581,713289,10
9/29/2015,450,450,459,450,2289,1030140,0
9/30/2015,450,450,468,442,4851,2200320,0
10/01/2015,459,450,460,444,5128,2310969,-9
10/04/2015,451,459,455,443,2200,991200,8
10/05/2015,445,451,460,442,2871,1282625,6
10/06/2015,440,445,445,435,5822,2551250,5
10/07/2015,450,440,450,440,511,226240,-10
10/08/2015,495,450,495,443,15581,7496975,-45
10/11/2015,530,495,544,504,93601,49644307,-35
10/14/2015,494,530,540,493,9865,4967086,36
10/15/2015,499,494,499,476,6688,3270296,-5
10/18/2015,495,499,495,487,8306,4064550,4
10/19/2015,500,495,500,489,2033,998600,-5
10/27/2015,472,481,472,465,3737,1751510,9
10/28/2015,466,472,472,455,2955,1368611,6
10/29/2015,470,466,475,466,1970,922200,-4
11/01/2015,456,470,469,450,4509,2063283,14
11/02/2015,461,456,470,450,3088,1434022,-5
11/03/2015,457,461,457,455,81,36915,4
11/04/2015,466,457,470,449,1462,681376,-9
11/05/2015,460,466,463,460,878,404480,6
11/08/2015,462,460,462,451,607,276552,-2
11/09/2015,483,462,483,469,4949,2351788,-21
11/10/2015,477,483,485,474,8443,4023172,6
11/15/2015,475,477,475,470,1170,553870,2
11/16/2015,471,475,471,467,250,116950,4
11/18/2015,470,471,475,467,1230,576640,1
11/19/2015,465,470,475,460,1940,912850,5
11/22/2015,452,465,460,451,2625,1190408,13
11/23/2015,452,452,452,449,4235,1907885,0
11/24/2015,455,452,461,451,1170,531661,-3
11/25/2015,450,455,461,448,6331,2852031,5
11/26/2015,447,450,450,435,2656,1172867,3
11/29/2015,420,447,442,420,9273,3936822,27
11/30/2015,431,420,450,424,4935,2134577,-11
12/01/2015,454,431,454,439,5943,2658366,-23
12/02/2015,451,454,451,445,3272,1468984,3
12/03/2015,450,451,459,450,3472,1572584,1
12/06/2015,465,450,468,459,2902,1335158,-15
12/07/2015,455,465,456,454,860,391040,10
12/08/2015,451,455,455,447,2091,946978,4
12/09/2015,469,451,469,460,1612,743343,-18
12/10/2015,465,469,469,450,934,429220,4
12/13/2015,456,465,465,456,1652,755440,9
12/14/2015,450,456,453,450,2818,1270993,6
12/15/2015,445,450,446,440,3918,1732598,5
12/16/2015,450,445,453,448,7554,3401659,-5
12/17/2015,465,450,468,451,1388,637154,-15
12/20/2015,481,465,483,462,16618,7859498,-16
12/21/2015,529,481,529,481,47347,24243546,-48
12/22/2015,512,529,559,510,21836,11421371,17
12/23/2015,496,512,510,496,6162,3098292,16
12/24/2015,510,496,510,490,11469,5764821,-14
12/27/2015,502,510,505,499,12349,6175634,8
12/28/2015,499,502,504,497,2290,1144350,3
12/29/2015,500,499,508,496,7138,3572922,-1
12/31/2015,508,500,513,500,5772,2944277,-8
1/03/2016,518,508,518,499,8407,4251883,-10
1/04/2016,506,518,528,502,6760,3441749,12
1/05/2016,505,506,515,500,4135,2078994,1
1/06/2016,500,505,507,495,4686,2343512,5
1/07/2016,515,500,520,505,7371,3793858,-15
1/10/2016,518,515,520,506,5622,2894903,-3
1/11/2016,525,518,529,511,11440,5985031,-7
1/12/2016,521,525,526,521,4907,2569746,4
1/12/2016,521,525,526,521,4907,2569746,4
1/13/2016,529,521,531,517,2677,1399719,-8
1/14/2016,545,529,545,524,22823,12096491,-16
1/17/2016,575,545,591,541,69927,39014550,-30
1/18/2016,580,575,608,561,19463,11291000,-5
1/19/2016,568,580,576,547,15212,8613242,12
1/20/2016,593,568,615,579,53666,31675099,-25
1/21/2016,583,593,600,577,23814,13960635,10
1/24/2016,599,583,599,589,34629,20527497,-16
1/25/2016,595,599,615,594,7231,4345564,4
1/26/2016,595,595,601,593,16386,9752865,0
1/27/2016,585,595,590,580,4958,2893376,10
1/28/2016,582,585,585,576,6324,3664624,3
1/31/2016,574,582,590,571,5068,2918430,8
2/01/2016,584,574,588,572,12969,7545537,-10
2/02/2016,580,584,595,580,7156,4168977,4
2/03/2016,574,580,580,572,4671,2684609,6
2/04/2016,589,574,589,573,11203,6492736,-15
2/07/2016,595,589,604,585,12440,7361320,-6
2/08/2016,590,595,594,584,10270,6059581,5
2/11/2016,580,590,590,580,4680,2730671,10
2/14/2016,570,580,579,561,7802,4436076,10
2/15/2016,590,570,590,555,10726,6061864,-20
2/16/2016,576,590,600,571,4767,2799893,14
2/17/2016,590,576,590,560,14601,8528821,-14
2/18/2016,588,590,596,588,20751,12270075,2
2/21/2016,590,588,598,585,21553,12728549,-2
2/22/2016,590,590,595,585,6229,3688123,0
2/23/2016,605,590,609,585,16364,9764387,-15
2/24/2016,595,605,603,590,4249,2518299,10
2/25/2016,585,595,605,581,5816,3430324,10
2/28/2016,590,585,595,587,10168,6007273,-5
2/29/2016,589,590,590,586,4735,2780790,1
3/01/2016,585,589,590,583,4675,2730512,4
3/02/2016,599,585,609,580,3609,2136405,-14
3/03/2016,617,599,620,590,31519,19177235,-18
3/06/2016,630,617,635,610,22567,14134927,-13
3/10/2016,693,630,693,640,69293,46707061,-63
3/13/2016,707,693,734,700,133833,95856392,-14
3/14/2016,672,707,715,665,31398,21493117,35
3/15/2016,665,672,674,655,14526,9613635,7
3/16/2016,674,665,679,655,9375,6249373,-9
3/17/2016,665,674,672,665,14604,9756375,9
3/20/2016,660,665,671,656,16552,10983700,5
3/21/2016,648,660,666,648,24495,16078607,12
3/23/2016,653,648,664,648,8568,5600722,-5
3/24/2016,655,653,678,651,11367,7485528,-2
3/27/2016,673,655,673,650,25338,16658204,-18
3/28/2016,671,673,685,658,16225,10830318,2
3/29/2016,669,671,673,657,7922,5281524,2
3/30/2016,665,669,680,661,8799,5864634,4
3/31/2016,658,665,663,655,7572,4988530,7
4/03/2016,670,658,690,652,15676,10478399,-12
4/04/2016,680,670,680,670,12643,8525338,-10
4/05/2016,684,680,685,670,22777,15508820,-4
4/06/2016,680,684,689,677,17535,11952975,4
4/10/2016,671,680,685,670,35135,23737440,9
4/11/2016,576,583,584,572,2445,1409412,7
4/12/2016,560,576,565,560,1071,603510,16
4/14/2016,591,560,591,560,3092,1771336,-31
4/17/2016,595,591,602,582,7426,4379665,-4
4/18/2016,612,595,612,570,12148,7248505,-17
4/19/2016,599,612,605,590,2370,1416095,13
4/20/2016,605,599,607,596,12246,7361983,-6
4/21/2016,630,605,630,595,26726,16235359,-25
4/24/2016,640,630,649,622,11906,7541497,-10
4/25/2016,655,640,663,641,11479,7493199,-15
4/26/2016,638,655,651,638,6470,4155678,17
4/27/2016,647,638,655,632,10197,6611583,-9
4/28/2016,638,647,651,638,7618,4933592,9
5/02/2016,640,638,645,627,18127,11467485,-2
5/03/2016,640,640,644,635,7259,4633403,0
5/04/2016,632,640,639,629,5406,3414300,8
5/05/2016,632,632,632,610,6608,4139075,0
5/08/2016,634,632,644,617,5668,3564553,-2
5/09/2016,649,634,663,640,20133,13029520,-15
5/10/2016,642,649,659,637,3444,2241677,7
5/11/2016,655,642,655,640,11538,7490374,-13
5/12/2016,673,655,673,655,26491,17477537,-18
5/15/2016,666,673,667,654,4754,3149707,7
5/16/2016,663,666,663,653,4406,2896216,3
5/17/2016,680,663,680,662,16189,10889112,-17
5/18/2016,683,680,693,680,7927,5423667,-3
5/19/2016,684,683,694,675,14300,9713996,-1
5/22/2016,680,684,686,670,2404,1636156,4
5/23/2016,685,680,690,677,14290,9764487,-5
5/24/2016,690,685,695,685,7665,5286530,-5
5/25/2016,682,690,692,671,13438,9073302,8
5/26/2016,679,682,689,657,5751,3902538,3
5/29/2016,679,679,679,660,10097,6749106,0
5/30/2016,666,679,679,665,6432,4287041,13
5/31/2016,659,666,667,653,7732,5098912,7
6/01/2016,656,659,665,648,10461,6845190,3
6/02/2016,668,656,682,656,14888,9934706,-12
6/05/2016,668,668,674,650,8658,5735256,0
6/06/2016,670,668,670,647,4113,2726752,-2
6/07/2016,677,670,680,661,9201,6186237,-7
6/08/2016,677,677,689,676,11892,8086110,0
6/09/2016,677,677,694,677,7948,5422602,0
6/12/2016,675,677,689,668,4476,3027832,2
6/13/2016,700,675,710,680,40671,28383419,-25
6/14/2016,721,700,725,710,35182,25298420,-21
6/15/2016,720,721,723,712,11057,7937373,1
6/16/2016,713,720,722,697,14568,10267030,7
6/19/2016,705,713,714,693,18341,12933260,8
6/20/2016,700,705,710,697,10740,7545962,5
6/21/2016,703,700,720,700,9949,7022531,-3
6/22/2016,720,703,728,706,11454,8181899,-17
6/23/2016,702,720,720,696,6052,4275171,18
6/26/2016,710,702,712,703,7223,5121182,-8
6/27/2016,739,710,739,713,22093,15966204,-29
6/28/2016,735,739,735,721,12542,9154895,4
6/29/2016,727,735,732,724,10899,7932804,8
6/30/2016,722,727,729,716,19936,14451845,5
7/03/2016,719,722,720,713,11526,8282487,3
7/04/2016,730,719,730,710,5677,4087850,-11
7/05/2016,745,730,750,713,20430,14750377,-15
7/06/2016,761,745,775,743,24816,18965190,-16
7/10/2016,761,761,765,740,4691,3548440,0
7/11/2016,777,761,789,761,27375,21279724,-16
7/12/2016,766,777,784,720,8705,6641752,11
7/13/2016,760,766,768,740,10620,8007271,6
7/14/2016,768,760,775,755,11763,8998421,-8
7/17/2016,844,768,844,765,46553,38156850,-76
7/18/2016,833,844,865,814,28713,24282672,11
7/19/2016,888,833,899,830,53355,46055239,-55
7/20/2016,976,888,976,900,73449,70610321,-88
7/21/2016,984,976,1010,954,43680,42840235,-8
7/25/2016,1065,984,1065,985,63729,64132381,-81
7/26/2016,1082,1065,1113,1045,37909,40983128,-17
7/27/2016,1081,1082,1099,1035,40667,43100183,1
7/28/2016,1060,1081,1069,1029,33191,34914371,21
8/01/2016,1030,1038,1050,995,33867,34223095,8
8/02/2016,1000,1030,1015,1000,58079,58488030,30
8/04/2016,970,1002,995,955,30904,30373426,32
8/07/2016,972,970,1006,970,25130,25039877,-2
8/08/2016,905,972,965,901,16460,15371467,67
8/09/2016,995,905,995,923,3567,3473347,-90
8/10/2016,1010,995,1020,936,53909,53784988,-15
8/11/2016,1020,1010,1020,992,33089,33098281,-10
8/14/2016,968,1020,1001,955,20556,20035729,52
8/15/2016,970,968,1006,946,27993,27328435,-2
8/16/2016,985,970,1001,970,30158,29962681,-15
8/17/2016,1000,985,1010,972,16569,16601481,-15
8/21/2016,995,1000,1013,985,8813,8816939,5
8/22/2016,964,995,1000,962,6697,6511253,31
8/23/2016,970,964,983,948,12823,12308227,-6
8/24/2016,970,970,984,951,7338,7059284,0
8/28/2016,965,970,980,958,5090,4924410,5
8/29/2016,983,965,995,965,14088,13758972,-18
8/30/2016,999,983,1002,983,16862,16755667,-16
8/31/2016,999,999,1005,985,19708,19578397,0
9/01/2016,998,999,1010,990,15887,15973715,1
9/03/2016,1020,998,1029,989,13611,13681335,-22
9/04/2016,1020,998,1029,989,13611,13681335,-22
9/05/2016,1043,1020,1056,1020,34803,36427617,-23
9/06/2016,1028,1043,1055,1011,25608,26702176,15
9/07/2016,1065,1028,1065,1011,62511,65481612,-37
9/08/2016,1054,1065,1058,1040,15717,16504253,11
9/11/2016,1050,1054,1075,1042,29449,30976283,4
9/12/2016,1050,1050,1060,1048,29095,30665683,0
9/14/2016,1050,1050,1059,1046,11695,12301220,0
9/18/2016,1050,1050,1052,1035,11307,11817951,0
9/20/2016,1044,1050,1071,1040,42584,44752147,6
9/21/2016,1025,1044,1045,1020,24012,24686690,19
9/22/2016,1019,1025,1032,997,31362,31848766,6
9/25/2016,995,1019,1020,990,114461,114824129,24
9/26/2016,675,697,690,659,10691,7175950,22
9/27/2016,672,675,684,672,4456,3015421,3
9/28/2016,672,672,677,670,1414,952154,0
9/29/2016,670,672,670,660,3261,2179255,2
10/02/2016,680,670,684,670,4644,3147376,-10
10/03/2016,672,680,690,670,2351,1602075,8
10/04/2016,668,672,680,667,7550,5062162,4
10/05/2016,680,668,680,667,1002,674106,-12
10/06/2016,683,680,690,670,2238,1518931,-3
10/16/2016,683,683,703,679,1795,1231305,0
10/17/2016,669,683,683,660,3931,2631477,14
10/18/2016,670,669,675,661,1206,804747,-1
10/19/2016,665,670,670,660,3950,2620054,5
10/20/2016,669,665,677,661,2944,1967195,-4
10/23/2016,655,669,665,655,6226,4100594,14
10/24/2016,653,655,661,649,7673,5004546,2
10/25/2016,645,653,650,640,3856,2481779,8
10/26/2016,642,645,650,640,4364,2809908,3
10/27/2016,638,642,645,630,2964,1899283,4
11/03/2016,645,638,650,626,906,577224,-7
11/07/2016,625,645,646,615,1784,1127016,20
11/08/2016,610,625,630,605,5340,3293823,15
11/09/2016,600,610,613,594,5406,3247293,10
11/10/2016,600,600,607,596,4874,2927348,0
11/13/2016,600,600,610,598,7038,4235385,0
11/14/2016,600,600,609,595,6752,4045871,0
11/15/2016,596,600,612,590,7995,4812885,4
11/16/2016,595,596,600,588,4803,2861582,1
11/17/2016,580,595,595,580,5087,2979229,15
11/20/2016,556,580,571,530,6046,3314277,24
11/21/2016,555,556,565,541,6653,3669875,1
11/22/2016,550,555,560,538,6174,3389711,5
11/23/2016,525,550,540,520,9827,5206229,25
11/24/2016,527,525,540,523,10536,5553951,-2
11/27/2016,502,527,528,500,14556,7400232,25
11/28/2016,525,502,535,480,20030,9903603,-23
11/29/2016,555,525,560,505,6827,3685039,-30
11/30/2016,576,555,589,550,17082,9590594,-21
12/01/2016,575,576,590,556,12639,7301002,1
12/04/2016,558,575,571,558,3739,2095270,17
12/05/2016,545,558,558,530,3418,1858251,13
12/06/2016,550,545,555,540,3030,1658237,-5
12/07/2016,550,550,553,543,1850,1014612,0
12/08/2016,540,550,550,540,4444,2408365,10
12/11/2016,530,540,541,529,3290,1755127,10
12/12/2016,525,530,530,515,1484,775586,5
12/14/2016,530,525,535,525,5246,2776288,-5
12/15/2016,542,530,542,530,4365,2336919,-12
12/18/2016,540,542,540,525,6847,3651601,2
12/19/2016,520,540,535,520,6963,3662720,20
12/20/2016,520,520,530,505,9974,5158258,0
12/21/2016,511,520,525,500,6654,3429880,9
12/22/2016,513,511,513,506,8026,4103396,-2
12/26/2016,497,513,510,497,7763,3894717,16
12/27/2016,495,497,506,483,10568,5233623,2
12/28/2016,498,495,505,495,5725,2863189,-3
12/29/2016,526,498,526,502,19494,10089179,-28
1/01/2017,545,526,555,535,18373,10076866,-19
1/02/2017,545,545,560,545,19457,10709727,0
1/03/2017,530,545,550,530,8202,4415197,15
1/04/2017,530,530,535,510,6130,3225775,0
1/05/2017,528,530,533,520,8287,4378949,2
1/08/2017,524,528,529,520,5593,2926079,4
1/09/2017,540,524,540,521,5545,2947042,-16
1/10/2017,540,540,550,540,4148,2249676,0
1/11/2017,540,540,550,540,8359,4558612,0
1/12/2017,542,540,546,531,5428,2925146,-2
1/15/2017,534,542,542,530,2339,1253888,8
1/16/2017,527,534,536,527,2058,1091490,7
1/17/2017,523,527,529,523,3270,1719022,4
1/18/2017,520,523,530,520,3386,1783070,3
1/19/2017,528,520,529,521,1913,1002025,-8
1/22/2017,526,528,531,526,2773,1466139,2
1/23/2017,520,526,524,520,2679,1395359,6
1/24/2017,508,520,530,500,7839,4008784,12
1/25/2017,490,508,505,480,25727,12653108,18
1/26/2017,460,490,490,455,33136,15482268,30
1/30/2017,442,460,465,442,12799,5774559,18
1/31/2017,458,442,464,435,11409,5152834,-16
2/01/2017,483,458,485,465,9886,4711204,-25
2/02/2017,483,483,500,480,15620,7632898,0
2/05/2017,470,483,492,470,3121,1489850,13
2/06/2017,455,470,468,455,5122,2362049,15
2/07/2017,455,455,463,451,4245,1938381,0
2/08/2017,450,455,460,448,9700,4386164,5
2/09/2017,445,450,453,440,12428,5537810,5
2/12/2017,429,445,453,416,11551,4886512,16
2/13/2017,440,429,443,413,11039,4662838,-11
2/14/2017,437,440,447,424,13085,5708474,3
2/15/2017,453,437,456,442,12899,5819825,-16
2/16/2017,453,453,460,450,16259,7356534,0
2/19/2017,445,453,452,441,23260,10365716,8
2/20/2017,440,445,455,440,17150,7643190,5
2/21/2017,439,440,465,437,18863,8376472,1
2/22/2017,434,439,442,430,22813,9908821,5
2/23/2017,440,434,442,427,14367,6260776,-6
2/26/2017,434,440,445,430,6391,2788327,6
2/28/2017,421,434,426,417,16732,7032221,13
3/01/2017,430,421,430,421,5008,2135041,-9
3/02/2017,435,430,435,425,5828,2521303,-5
3/05/2017,443,435,448,432,12347,5458931,-8
3/06/2017,449,443,456,446,9615,4316175,-6
3/07/2017,439,449,443,439,5596,2467237,10
3/09/2017,445,439,452,444,3547,1583560,-6
3/13/2017,440,445,450,440,5870,2600359,5
3/14/2017,441,440,450,440,9273,4113210,-1
3/15/2017,448,441,449,443,3091,1376749,-7
3/16/2017,445,448,452,441,9046,4012644,3
3/19/2017,451,445,454,445,10196,4592620,-6
3/20/2017,461,451,465,455,16216,7455757,-10
3/21/2017,484,461,484,460,26819,12587312,-23
3/22/2017,492,484,515,485,45578,22838969,-8
3/23/2017,511,492,514,493,42052,21317008,-19
3/26/2017,562,511,562,512,86224,47708756,-51
3/28/2017,595,562,606,573,63335,37423649,-33
3/29/2017,565,595,615,550,118955,68723660,30
3/30/2017,574,565,577,555,151987,86067068,-9
4/03/2017,504,478,525,487,86048,43752580,-26
4/04/2017,495,504,508,480,38622,19049502,9
4/06/2017,482,495,495,474,42085,20121788,13
4/09/2017,472,482,485,470,26361,12443931,10
4/10/2017,471,472,485,467,24705,11622539,1
4/11/2017,489,471,494,470,29427,14275730,-18
4/12/2017,480,489,500,480,43976,21570036,9
4/13/2017,472,480,482,468,25576,12157715,8
4/16/2017,460,472,481,457,14433,6817342,12
4/18/2017,450,460,460,443,26897,12146144,10
4/19/2017,463,450,469,453,15551,7173984,-13
4/20/2017,465,463,483,463,32994,15564848,-2
4/23/2017,472,465,511,472,45549,21857591,-7
4/24/2017,469,472,474,466,23133,10859181,3
4/25/2017,469,469,472,464,17195,8041381,0
4/26/2017,467,469,472,465,9098,4257990,2
4/27/2017,466,467,475,463,15743,7381184,1
4/30/2017,459,466,470,454,18728,8571257,7
5/02/2017,461,459,468,445,22562,10244556,-2
5/03/2017,461,461,478,457,13689,6359865,0
5/04/2017,460,461,478,454,10579,4862372,1
5/07/2017,454,460,464,453,5619,2567369,6
5/08/2017,460,454,465,446,16791,7593535,-6
5/09/2017,457,460,461,452,21081,9605186,3
5/11/2017,464,457,466,461,12423,5755865,-7
5/15/2017,465,464,471,460,10542,4873562,-1
5/16/2017,456,465,465,455,7225,3308817,9
5/17/2017,455,456,460,454,4811,2194661,1
5/18/2017,451,455,458,450,6117,2771963,4
5/21/2017,450,451,460,444,10460,4687103,1
5/22/2017,448,450,450,441,3174,1418900,2
5/23/2017,450,448,455,443,6912,3118403,-2
5/24/2017,455,450,456,448,11662,5282774,-5
5/28/2017,450,455,455,445,9086,4093677,5
5/30/2017,444,450,450,441,7182,3193641,6
5/31/2017,450,444,455,439,8719,3870695,-6
6/01/2017,446,450,459,444,14518,6514331,4
6/04/2017,445,446,450,440,10779,4796056,1
6/05/2017,443,445,450,443,12176,5438368,2
6/06/2017,454,443,458,448,10899,4918322,-11
6/07/2017,453,454,463,450,14334,6502554,1
6/08/2017,449,453,452,444,6842,3058885,4
6/11/2017,444,449,448,440,7886,3493484,5
6/12/2017,445,444,446,434,9184,4039315,-1
6/13/2017,435,445,444,435,13963,6114368,10
6/14/2017,435,435,440,434,8869,3869751,0
6/15/2017,440,435,442,432,15064,6569564,-5
6/18/2017,431,440,440,428,19261,8290076,9
6/19/2017,427,431,431,417,21359,9040694,4
6/20/2017,423,427,429,415,12740,5380466,4
6/21/2017,421,423,425,417,6334,2673676,2
6/22/2017,421,421,429,420,16465,6949115,0
6/25/2017,423,421,426,419,10516,4451695,-2
6/27/2017,422,423,425,420,11352,4795475,1
6/28/2017,428,422,428,415,10162,4287790,-6
7/02/2017,428,428,430,419,14946,6315356,0
7/03/2017,423,428,430,420,7794,3311499,5
7/04/2017,420,423,426,419,13712,5768673,3
7/05/2017,425,420,425,419,11348,4786382,-5
7/06/2017,437,425,437,425,18660,7970364,-12
7/09/2017,441,437,446,430,20091,8794058,-4
7/10/2017,433,441,440,430,12785,5585373,8
7/11/2017,435,433,440,430,9864,4318391,-2
7/12/2017,432,435,440,432,8794,3825056,3
7/13/2017,435,432,437,430,12875,5549593,-3
7/16/2017,433,435,435,430,4465,1927023,2
7/17/2017,448,433,448,433,16129,7096066,-15
7/18/2017,472,448,472,449,27796,12739662,-24
7/19/2017,460,472,470,460,21239,9884869,12
7/20/2017,461,460,465,454,10954,5040009,-1
7/23/2017,459,461,465,455,16709,7668931,2
7/24/2017,455,459,460,454,13393,6112032,4
7/25/2017,458,455,461,454,16138,7380111,-3
7/26/2017,450,458,460,448,22953,10401083,8
7/27/2017,460,450,460,450,11335,5133609,-10
7/30/2017,451,460,461,445,9537,4331121,9
7/31/2017,453,451,459,450,12315,5598249,-2
8/01/2017,454,453,469,450,9280,4235329,-1
8/02/2017,454,454,456,453,12168,5532203,0
8/03/2017,453,454,459,450,14097,6379143,1
8/06/2017,454,453,456,450,18930,8598441,-1
8/07/2017,453,454,463,452,11926,5419900,1
8/09/2017,450,453,460,444,17516,7934355,3
8/10/2017,450,450,454,443,21245,9497817,0
8/13/2017,445,450,449,440,14415,6423464,5
8/15/2017,441,445,446,441,15104,6699557,4
8/16/2017,444,441,448,442,11304,5021857,-3
8/17/2017,443,444,449,438,23326,10279553,1
8/20/2017,440,443,444,435,16054,7075869,3
8/21/2017,438,440,442,432,5674,2474784,2
8/22/2017,441,438,442,436,12396,5447828,-3
8/23/2017,441,441,442,438,7718,3396666,0
8/24/2017,443,441,453,434,11438,5093781,-2
8/27/2017,446,443,451,443,3889,1732805,-3
8/28/2017,446,446,452,444,7897,3519687,0
8/30/2017,438,446,443,435,14820,6508340,8
8/31/2017,437,438,438,432,15528,6769346,1
9/04/2017,430,437,439,426,33009,14133477,7
9/06/2017,438,430,440,425,11603,4994219,-8
9/07/2017,428,438,438,426,34082,14711435,10
9/10/2017,425,428,431,423,37704,16076730,3
9/11/2017,424,425,430,420,17950,7592940,1
9/12/2017,421,424,426,420,27903,11782776,3
9/13/2017,420,421,423,418,32249,13538906,1
9/14/2017,447,420,447,419,42524,18361183,-27
9/17/2017,447,447,459,438,49764,22001355,0
9/18/2017,443,447,452,443,33400,14877419,4
9/20/2017,439,443,443,435,10450,4599400,4
9/24/2017,441,439,443,439,3718,1638796,-2
9/25/2017,448,441,448,440,2882,1272835,-7
9/26/2017,448,448,449,443,5132,2286875,0
10/03/2017,453,448,453,446,3164,1415634,-5
10/04/2017,440,453,450,437,6475,2854121,13
10/08/2017,432,440,432,420,15759,6712529,8
10/09/2017,431,432,433,425,17649,7561101,1
10/10/2017,427,431,438,423,19003,8118044,4
10/11/2017,428,427,431,425,11993,5132940,-1
10/12/2017,429,428,435,428,5474,2357856,-1
10/15/2017,433,429,433,427,5553,2393186,-4
10/16/2017,442,433,451,434,18696,8294486,-9
10/17/2017,449,442,450,436,12124,5388922,-7
10/18/2017,444,449,450,438,12688,5628714,5
10/22/2017,450,444,458,436,11183,5051656,-6
10/23/2017,449,450,455,445,12644,5695162,1
10/24/2017,448,449,452,445,9549,4278475,1
10/25/2017,449,448,451,444,17137,7675865,-1
10/29/2017,442,449,447,440,7203,3185825,7
10/30/2017,437,442,443,437,13723,6029799,5
10/31/2017,437,437,440,433,8889,3866223,0
11/01/2017,434,437,437,429,6291,2725033,3
11/02/2017,440,434,442,430,8331,3632384,-6
11/05/2017,430,440,440,424,16936,7255084,10
11/06/2017,429,430,430,420,29796,12642926,1
11/07/2017,422,429,436,420,26141,11088659,7
11/08/2017,416,422,422,414,17305,7217966,6
11/09/2017,415,416,427,412,9434,3918031,1
11/12/2017,423,415,425,415,9098,3815462,-8
11/13/2017,428,423,428,420,14684,6245012,-5
11/14/2017,432,428,434,424,14580,6256963,-4
11/15/2017,428,432,432,426,3596,1544399,4
11/16/2017,420,428,435,420,13740,5797379,8
11/19/2017,420,420,422,412,13373,5575148,0
11/20/2017,421,420,422,418,4579,1923518,-1
11/21/2017,423,421,425,421,4762,2015105,-2
11/22/2017,425,423,429,421,5998,2539736,-2
11/23/2017,425,425,430,425,7260,3103718,0
11/26/2017,432,425,441,425,10953,4710293,-7
11/27/2017,430,432,435,430,6918,2983035,2
11/28/2017,431,430,432,425,12551,5401048,-1
11/29/2017,436,431,439,430,19013,8283527,-5
11/30/2017,437,436,438,431,10518,4566994,-1
12/04/2017,435,437,437,430,10306,4465824,2
12/05/2017,431,435,442,430,6588,2837524,4
12/06/2017,435,431,437,426,9725,4204614,-4
12/10/2017,430,435,451,428,11646,5072147,5
12/11/2017,431,430,433,424,12873,5506814,-1
12/12/2017,427,431,431,426,15642,6693617,4
12/13/2017,428,427,431,421,4262,1812383,-1
12/14/2017,425,428,433,424,5967,2540238,3
12/17/2017,423,425,430,423,6121,2599496,2
12/18/2017,426,423,426,422,4333,1839010,-3
12/19/2017,424,426,426,421,8052,3410220,2
12/20/2017,422,424,426,419,3192,1350383,2
12/21/2017,420,422,423,417,7557,3178267,2
12/24/2017,421,420,428,420,7917,3341185,-1
12/26/2017,420,421,426,411,7244,3040975,1
12/27/2017,415,420,418,408,11368,4701950,5
12/28/2017,410,415,417,400,9917,4064962,5
12/31/2017,402,410,409,400,27546,11089087,8
1/01/2018,414,402,414,405,6665,2726955,-12
1/02/2018,425,414,430,416,55870,23639633,-11
1/03/2018,422,425,428,419,15373,6515991,3
1/04/2018,421,422,421,416,5788,2425843,1
1/07/2018,423,421,429,416,18051,7598573,-2
1/08/2018,425,423,430,420,8389,3558019,-2
1/09/2018,425,425,427,422,7302,3105363,0
1/10/2018,425,425,427,421,7277,3089550,0
1/14/2018,420,425,427,417,10523,4415231,5
1/16/2018,417,420,421,415,4270,1778362,3
1/17/2018,413,417,417,409,6401,2647102,4
1/21/2018,419,413,420,413,21733,9065805,-6
1/22/2018,420,419,422,418,18056,7571323,-1
1/23/2018,416,420,421,415,15725,6564115,4
1/24/2018,419,416,420,412,14131,5896929,-3
1/25/2018,420,419,420,417,13110,5476669,-1
1/28/2018,415,420,423,415,49337,20640167,5
1/29/2018,340,346,347,340,8266,2828715,6
1/31/2018,344,340,344,340,4790,1636893,-4
2/01/2018,344,344,345,343,6191,2133740,0
2/04/2018,350,344,350,342,8959,3116418,-6
2/05/2018,342,350,350,342,8109,2793340,8
2/06/2018,347,342,347,340,5214,1780333,-5
2/07/2018,342,347,346,341,5012,1715421,5
2/08/2018,342,342,345,336,3523,1208072,0
2/11/2018,342,342,343,341,1760,601865,0
2/12/2018,340,342,342,340,3785,1289922,2
2/14/2018,340,340,342,335,4167,1408438,0
2/15/2018,350,340,350,341,7548,2607158,-10
2/18/2018,350,355,359,348,11904,4191852,5
2/20/2018,340,350,351,340,6728,2317045,10
2/21/2018,340,341,341,339,2461,836966,1
2/22/2018,340,341,342,338,4099,1394160,1
2/25/2018,338,342,342,335,3932,1323562,4
2/26/2018,335,337,337,335,4951,1661667,2
2/27/2018,338,334,342,332,4409,1484882,-4
2/28/2018,334,338,339,334,13018,4369744,4
3/04/2018,328,328,330,325,16726,5461805,0
3/05/2018,324,329,330,323,16594,5384502,5
3/06/2018,327,320,328,320,5748,1861617,-7
3/07/2018,330,327,333,327,6817,2256339,-3
3/11/2018,326,331,331,326,6491,2131371,5
3/12/2018,328,326,331,326,10231,3365920,-2
3/13/2018,333,328,333,327,8561,2828509,-5
3/14/2018,335,330,335,328,8410,2787208,-5
3/15/2018,335,330,337,330,10440,3496620,-5
3/18/2018,334,339,339,333,5791,1934030,5
3/19/2018,325,335,335,325,5937,1939750,10
3/20/2018,323,321,327,321,2133,689613,-2
3/21/2018,316,317,321,314,11081,3509629,1
3/22/2018,316,319,320,310,6600,2077888,3
3/26/2018,300,310,313,299,10390,3161312,10
3/27/2018,316,306,326,283,16469,4927113,-10
3/28/2018,311,316,317,307,12154,3801930,5
3/29/2018,318,311,320,311,8252,2610653,-7
4/01/2018,313,320,320,308,6979,2181409,7
4/02/2018,314,314,318,310,6267,1957517,0
4/03/2018,315,310,318,310,3431,1080948,-5
4/04/2018,325,316,326,315,12813,4139091,-9
4/05/2018,331,330,335,321,22167,7296728,-1
4/08/2018,340,333,348,331,17000,5765359,-7
4/09/2018,335,341,346,334,13810,4682890,6
4/10/2018,334,330,337,325,6099,2023472,-4
4/11/2018,335,332,335,328,5135,1702717,-3
4/12/2018,337,336,340,332,9067,3064628,-1
4/15/2018,340,335,340,326,7648,2538264,-5
4/16/2018,338,340,341,335,5765,1952451,2
4/17/2018,337,340,343,336,17345,5875128,3
4/18/2018,345,340,354,337,17497,6018812,-5
4/19/2018,351,351,353,347,24467,8591259,0
4/22/2018,369,352,370,352,36790,13381295,-17
4/23/2018,360,376,382,360,39505,14550792,16
4/24/2018,359,355,365,345,16417,5863413,-4
4/25/2018,352,360,360,351,10118,3576536,8
4/26/2018,348,353,354,345,10047,3496945,5
4/29/2018,344,342,348,337,10608,3637412,-2
5/02/2018,341,340,342,338,5447,1851294,-1
5/03/2018,346,343,352,343,9858,3429602,-3
5/06/2018,343,346,346,343,9671,3330659,3
5/07/2018,343,340,345,339,6251,2139147,-3
5/08/2018,343,343,343,340,5181,1766629,0
5/09/2018,344,345,347,344,6849,2366426,1
5/10/2018,343,340,346,337,11575,3945761,-3
5/14/2018,341,339,344,338,4201,1434612,-2
5/15/2018,339,341,342,337,2916,987956,2
5/16/2018,341,338,344,337,3039,1034751,-3
5/17/2018,339,342,343,339,6983,2384710,3
5/20/2018,340,342,344,338,9261,3153251,2
5/21/2018,340,335,340,335,10925,3694072,-5
5/22/2018,337,335,340,335,6973,2356133,-2
5/23/2018,334,340,340,334,8116,2724352,6
5/24/2018,335,335,338,335,5963,2000585,0
5/27/2018,332,335,335,330,6118,2031966,3
5/28/2018,340,330,347,328,5764,1932420,-10
5/29/2018,337,340,342,334,9698,3277168,3
5/30/2018,340,337,340,335,11065,3743869,-3
5/31/2018,339,340,340,337,8381,2838507,1
6/03/2018,330,335,336,326,14980,4957981,5
6/04/2018,329,326,331,324,6154,2011614,-3
6/06/2018,336,332,340,332,3379,1135007,-4
6/07/2018,327,336,336,325,3481,1144588,9
6/10/2018,317,327,327,314,9920,3149847,10
6/11/2018,323,317,326,316,5594,1785266,-6
6/12/2018,320,319,323,317,3235,1035928,-1
6/13/2018,318,320,322,316,3924,1252218,2
6/14/2018,321,319,324,319,3956,1273859,-2
6/17/2018,320,320,320,314,1083,342522,0
6/18/2018,320,320,320,310,6878,2154552,0
6/19/2018,316,322,322,316,3309,1049133,6
6/20/2018,312,314,314,309,5309,1648950,2
6/21/2018,310,310,316,310,9336,2916902,0
6/24/2018,314,306,317,306,3045,952280,-8
6/25/2018,313,316,316,311,3561,1112513,3
6/26/2018,311,311,313,307,7623,2363209,0
6/27/2018,311,310,312,308,1402,434695,-1
6/28/2018,312,310,312,308,10595,3294320,-2
7/01/2018,305,311,311,305,5338,1635939,6
7/02/2018,305,300,308,299,4610,1399846,-5
7/03/2018,305,302,308,302,3991,1216907,-3
7/04/2018,309,305,310,300,8901,2722256,-4
7/05/2018,318,312,318,311,2638,831225,-6
7/08/2018,316,317,321,316,9349,2977036,1
7/09/2018,310,316,316,308,4364,1359099,6
7/10/2018,313,311,314,310,47740,14801288,-2
7/11/2018,312,315,317,310,40507,12590795,3
7/12/2018,310,313,315,310,12730,3959540,3
7/15/2018,311,309,314,309,2890,900469,-2
7/16/2018,314,311,315,311,32979,10348996,-3
7/17/2018,315,316,317,315,1983,625393,1
7/18/2018,317,315,317,313,3133,986121,-2
7/19/2018,315,316,317,311,6170,1941530,1
7/22/2018,314,314,316,313,8337,2621323,0
7/23/2018,313,314,317,313,3905,1228033,1
7/24/2018,313,313,318,313,7297,2301641,0
7/25/2018,314,315,315,311,6281,1964546,1
7/26/2018,315,314,315,313,5608,1760548,-1
7/29/2018,318,318,319,315,9058,2864572,0
7/30/2018,319,316,319,315,5984,1893378,-3
7/31/2018,321,319,321,318,7541,2409044,-2
8/01/2018,322,319,323,319,9526,3068018,-3
8/02/2018,327,322,327,321,5188,1679864,-5
8/05/2018,328,327,328,325,3712,1212817,-1
8/06/2018,326,328,328,325,9520,3097930,2
8/07/2018,326,325,326,324,4342,1408593,-1
8/08/2018,325,325,327,322,1567,507941,0
8/09/2018,325,322,325,319,5748,1845495,-3
8/12/2018,320,322,322,313,3439,1089860,2
8/13/2018,317,315,319,315,2778,880111,-2
8/14/2018,324,317,324,317,6036,1929291,-7
8/15/2018,339,326,343,326,37824,12610377,-13
8/16/2018,340,344,345,335,25581,8716335,4
8/19/2018,338,344,344,338,21370,7262350,6
8/20/2018,335,340,340,332,14359,4793035,5
8/21/2018,333,335,335,331,8787,2926568,2
8/22/2018,344,335,344,331,3613,1202035,-9
8/23/2018,335,338,338,333,7504,2509987,3
8/26/2018,333,335,337,330,3588,1191503,2
8/28/2018,333,333,335,330,7354,2440995,0
8/29/2018,331,334,334,330,6392,2115838,3
8/30/2018,334,331,335,331,9985,3324675,-3
9/02/2018,340,333,340,333,9661,3250843,-7
9/03/2018,342,336,347,336,15425,5299787,-6
9/04/2018,344,340,347,340,17187,5922672,-4
9/05/2018,356,341,362,341,29704,10487643,-15
9/06/2018,352,360,368,350,33936,12121035,8
9/09/2018,346,353,353,346,7740,2699031,7
9/10/2018,342,346,346,340,4112,1413271,4
9/11/2018,345,340,350,340,4778,1658010,-5
9/12/2018,352,345,355,345,12667,4433730,-7
9/13/2018,359,352,359,351,20006,7079797,-7
9/16/2018,367,360,377,356,53133,19495815,-7
9/17/2018,360,367,370,359,21307,7702269,7
9/18/2018,359,358,362,357,9249,3326117,-1
9/20/2018,359,352,364,352,9880,3560226,-7
9/23/2018,361,364,364,357,19281,6965783,3
9/25/2018,371,361,373,361,44925,16546069,-10
9/26/2018,365,372,375,364,18655,6883797,7
9/27/2018,365,365,370,365,14911,5477305,0
9/30/2018,361,362,366,361,11183,4056016,1
10/01/2018,352,358,362,352,21976,7847500,6
10/02/2018,353,352,358,352,12983,4605484,-1
10/03/2018,347,352,354,347,28516,9964261,5
10/04/2018,348,350,350,345,15025,5220906,2
10/07/2018,344,345,348,344,10164,3510504,1
10/08/2018,349,344,357,344,9581,3332671,-5
10/09/2018,347,350,350,347,9551,3329450,3
10/10/2018,347,347,348,345,6502,2251599,0
10/11/2018,350,349,352,346,10534,3684791,-1
10/14/2018,357,352,358,350,12769,4518296,-5
10/15/2018,354,364,364,354,11617,4142312,10
10/21/2018,355,361,361,355,3483,1241372,6
10/22/2018,355,355,355,352,3196,1132136,0
10/23/2018,358,355,358,354,6474,2298042,-3
10/24/2018,358,355,358,353,3065,1090911,-3
10/25/2018,357,358,358,355,5436,1935652,1
10/28/2018,353,355,355,350,11851,4169346,2
10/29/2018,350,350,351,348,8152,2848363,0
10/30/2018,352,349,354,348,11760,4125176,-3
10/31/2018,352,359,355,350,9391,3301581,7
11/01/2018,352,350,352,350,6758,2373718,-2
11/04/2018,348,350,353,348,15056,5270628,2
11/05/2018,349,348,352,348,10438,3650891,-1
11/06/2018,354,349,354,348,1030,364620,-5
11/11/2018,352,354,356,352,3083,1088481,2
11/12/2018,348,349,352,347,1885,656791,1
11/13/2018,349,349,351,348,3940,1379311,0
11/14/2018,350,349,352,349,1763,617198,-1
11/15/2018,349,350,351,348,5701,1993336,1
11/18/2018,345,347,347,343,6006,2070045,2
11/19/2018,346,347,347,344,5455,1882026,1
11/20/2018,347,349,349,342,2001,688135,2
11/21/2018,343,353,353,342,6780,2333168,10
11/22/2018,344,340,345,340,6445,2217675,-4
11/25/2018,341,345,345,341,8678,2973479,4
11/26/2018,339,340,340,335,5374,1819930,1
11/27/2018,340,338,346,338,5914,2015501,-2
11/28/2018,340,340,340,339,2677,909102,0
11/29/2018,338,337,340,336,6964,2348674,-1
12/02/2018,333,335,336,329,9756,3232404,2
12/03/2018,330,332,335,329,9202,3048582,2
12/04/2018,334,326,335,326,2973,988616,-8
12/05/2018,329,340,340,326,21447,7063344,11
12/06/2018,327,323,331,320,8394,2724034,-4
12/09/2018,335,327,335,327,2982,982730,-8
12/10/2018,335,334,340,330,5830,1958343,-1
12/11/2018,336,335,339,333,3705,1242067,-1
12/12/2018,337,341,341,337,990,335180,4
12/13/2018,338,337,345,335,5226,1774269,-1
12/16/2018,344,344,344,341,18570,6353690,0
12/17/2018,355,341,355,340,5225,1824890,-14
12/18/2018,344,355,355,343,10127,3507399,11
12/19/2018,343,344,345,342,3717,1275257,1
12/20/2018,349,347,351,346,14032,4890441,-2
12/23/2018,357,355,362,352,16974,6027783,-2
12/24/2018,357,361,362,352,14350,5113123,4
12/25/2018,353,352,353,351,8383,2949174,-1
12/26/2018,362,353,362,352,22157,7935447,-9
12/27/2018,359,362,365,358,36773,13261233,3
12/30/2018,351,359,359,351,11317,3996299,8
12/31/2018,349,350,352,347,14754,5143638,1
1/01/2019,346,346,350,344,22211,7679732,0
1/02/2019,345,347,347,345,7467,2579702,2
1/03/2019,345,340,348,340,7294,2525136,-5
1/06/2019,344,348,352,344,9776,3397795,4
1/07/2019,346,344,350,344,2680,927285,-2
1/08/2019,349,347,349,347,8069,2806308,-2
1/09/2019,348,349,351,348,8599,3009488,1
1/10/2019,350,354,354,348,4955,1731162,4
1/13/2019,349,357,357,346,22250,7819638,8
1/14/2019,350,350,351,348,20430,7119464,0
1/15/2019,350,348,350,348,7663,2680602,-2
1/16/2019,350,350,351,348,9525,3331492,0
1/17/2019,345,347,350,345,3486,1211240,2
1/20/2019,345,345,345,341,3502,1200568,0
1/21/2019,342,345,346,340,6616,2261498,3
1/22/2019,343,338,343,337,5188,1766808,-5
1/23/2019,343,343,344,342,2273,779371,0
1/24/2019,342,344,344,342,16140,5534274,2
1/27/2019,339,342,342,339,4235,1440935,3
1/28/2019,342,339,345,338,8647,2942284,-3
1/29/2019,341,342,342,340,2612,890323,1
1/30/2019,339,340,341,339,3892,1321885,1
1/31/2019,339,342,342,339,5850,1987034,3
2/03/2019,338,337,340,337,12977,4394242,-1
2/04/2019,339,338,340,335,13265,4473593,-1
2/05/2019,338,340,340,338,5648,1918507,2
2/06/2019,335,352,352,335,6099,2052857,17
2/07/2019,334,330,337,330,5500,1833345,-4
2/10/2019,332,335,335,330,6098,2020161,3
2/11/2019,332,328,335,328,6268,2083996,-4
2/12/2019,332,330,333,330,5722,1891110,-2
2/13/2019,329,330,332,329,13830,4573349,1
2/14/2019,330,331,331,327,13107,4305232,1
2/17/2019,330,330,336,328,18875,6240959,0
2/18/2019,329,328,330,325,9327,3059976,-1
2/19/2019,333,324,333,324,3150,1037416,-9
2/20/2019,329,333,333,329,2685,885805,4
2/21/2019,333,329,335,329,9054,3009340,-4
2/24/2019,330,333,333,329,6833,2254037,3
2/25/2019,331,332,333,327,15959,5247484,1
2/26/2019,332,331,334,331,18064,5988178,-1
2/27/2019,333,330,335,330,27442,9131780,-3
3/03/2019,294,308,308,291,14076,4152484,14
3/05/2019,292,291,294,291,5732,1676605,-1
3/06/2019,292,292,293,290,2085,607485,0
3/07/2019,294,292,294,290,8624,2525631,-2
3/10/2019,294,294,294,292,2777,812277,0
3/11/2019,298,298,301,295,9999,2968677,0
3/12/2019,305,300,306,298,16058,4841461,-5
3/13/2019,303,305,306,300,14926,4535107,2
3/14/2019,302,301,303,296,6707,2011744,-1
3/17/2019,302,303,305,300,8247,2493508,1
3/18/2019,301,303,304,301,10211,3081183,2
3/19/2019,298,301,301,298,3883,1161810,3
3/21/2019,296,297,300,296,3230,958182,1
3/24/2019,293,299,299,293,8327,2456898,6
3/25/2019,294,294,298,292,8653,2542696,0
3/26/2019,294,298,298,293,10218,3004027,4
3/27/2019,294,296,299,293,4409,1297607,2
3/28/2019,294,298,298,292,9227,2717238,4
3/31/2019,295,296,296,293,11187,3297517,1
4/01/2019,297,295,297,292,12690,3727397,-2
4/02/2019,302,299,304,299,15332,4614974,-3
4/03/2019,305,301,307,301,15802,4801499,-4
4/04/2019,304,305,305,301,11579,3514973,1
4/07/2019,309,301,309,298,11864,3608242,-8
4/08/2019,316,311,320,310,21933,6888574,-5
4/09/2019,311,311,318,311,21533,6760574,0
4/10/2019,312,312,314,310,8299,2589517,0
4/11/2019,315,313,319,313,22147,6995031,-2
4/15/2019,318,313,318,313,11551,3644602,-5
4/16/2019,326,313,327,313,17829,5743883,-13
4/17/2019,338,332,338,326,24403,8139156,-6
4/18/2019,350,341,350,336,49470,17024357,-9
4/21/2019,348,350,350,343,28028,9683001,2
4/22/2019,342,353,353,336,19348,6651134,11
4/23/2019,346,346,346,340,17832,6131042,0
4/24/2019,354,342,354,341,68938,24151432,-12
4/25/2019,388,354,389,354,145400,54368454,-34
4/28/2019,395,395,410,389,111393,44012947,0
4/29/2019,389,395,395,383,45136,17504758,6
4/30/2019,390,389,391,382,27561,10693644,-1
5/02/2019,385,383,387,381,24698,9481016,-2
5/05/2019,379,385,385,376,55477,21102433,6
5/06/2019,388,377,388,374,40670,15477317,-11
5/07/2019,389,390,390,384,39057,15128947,1
5/08/2019,388,388,390,384,35169,13592595,0
5/09/2019,388,394,396,386,94677,36879426,6
5/12/2019,390,387,390,384,17340,6710113,-3
5/13/2019,386,390,391,384,20540,7973653,4
5/14/2019,416,388,421,388,194265,78698606,-28
5/15/2019,438,417,447,416,133601,57604100,-21
5/16/2019,421,445,445,421,112016,48120933,24
5/19/2019,422,425,430,416,67027,28287316,3
5/20/2019,418,430,432,416,59854,25421001,12
5/21/2019,418,421,422,413,42776,17914835,3
5/22/2019,424,420,426,418,92882,39158539,-4
5/23/2019,431,427,438,426,97795,42269147,-4
5/26/2019,425,432,434,423,50429,21534332,7
5/27/2019,422,419,426,419,44153,18639138,-3
5/28/2019,421,428,428,420,13321,5614326,7
5/29/2019,424,422,426,420,54281,22860673,-2
5/30/2019,428,437,451,426,94006,40819611,9
6/02/2019,422,433,433,420,29715,12545548,11
6/03/2019,414,430,430,414,64123,26762825,16
6/04/2019,416,415,420,414,48716,20235238,-1
6/06/2019,413,418,418,413,25497,10575644,5
6/10/2019,412,413,416,411,33018,13633201,1
6/11/2019,416,412,417,412,62742,25967297,-4
6/12/2019,415,413,415,411,17469,7220128,-2
6/13/2019,411,412,415,411,30086,12412971,1
6/16/2019,404,411,411,404,44708,18167621,7
6/17/2019,403,404,406,402,42955,17362298,1
6/18/2019,402,403,405,401,24044,9692672,1
6/19/2019,404,402,404,400,23061,9290711,-2
6/20/2019,406,409,409,403,11029,4473915,3
6/23/2019,405,405,407,403,6869,2783450,0
6/24/2019,411,403,413,403,37528,15355103,-8
6/25/2019,416,413,417,411,25298,10492517,-3
6/26/2019,413,418,418,412,17369,7178981,5
6/27/2019,413,413,413,410,18552,7645088,0
6/30/2019,407,413,413,406,11120,4556249,6
7/01/2019,405,408,408,404,12593,5116376,3
7/02/2019,410,404,413,404,21391,8710902,-6
7/03/2019,414,408,415,407,24200,9954921,-6
7/04/2019,411,415,415,410,16330,6718284,4
7/07/2019,408,408,410,407,30964,12640382,0
7/08/2019,406,410,410,405,29244,11881049,4
7/09/2019,405,402,407,401,9165,3709286,-3
7/10/2019,407,405,407,402,26313,10659137,-2
7/11/2019,405,407,410,405,19978,8131280,2
7/14/2019,406,411,411,405,10033,4077461,5
7/15/2019,406,406,408,405,9018,3661194,0
7/16/2019,409,426,426,406,8675,3551664,17
7/17/2019,417,408,418,408,29854,12373748,-9
7/18/2019,418,413,423,413,20493,8606616,-5
7/21/2019,414,414,417,411,14478,5983850,0
7/22/2019,416,414,419,414,19276,8027232,-2
7/23/2019,435,418,435,418,105508,45122369,-17
7/24/2019,433,435,435,428,61735,26669384,2
7/25/2019,430,433,434,427,97104,41832806,3
7/28/2019,425,423,429,422,96129,40824306,-2
7/29/2019,427,425,430,425,35679,15252712,-2
7/30/2019,429,426,431,426,31788,13636050,-3
7/31/2019,431,422,433,422,42713,18385719,-9
8/01/2019,430,436,436,429,37084,15978023,6
8/04/2019,437,429,438,424,68518,29635044,-8
8/05/2019,433,433,437,431,44680,19438245,0
8/06/2019,432,441,442,430,196356,85441368,9
8/07/2019,435,426,439,426,56560,24597261,-9
8/08/2019,431,435,435,429,34679,14952091,4
8/11/2019,430,430,431,428,25832,11083039,0
8/12/2019,431,433,433,429,20621,8874359,2
8/13/2019,428,431,437,428,17896,7684296,3
8/14/2019,429,426,430,425,13082,5611375,-3
8/15/2019,430,427,433,425,36318,15617733,-3
8/18/2019,430,430,433,429,36698,15791949,0
8/19/2019,431,431,434,429,38717,16664649,0
8/20/2019,427,431,432,427,17383,7450235,4
8/21/2019,429,425,430,425,20878,8931846,-4
8/22/2019,428,429,430,425,28290,12073166,1
8/25/2019,427,423,427,423,20297,8636520,-4
8/26/2019,425,430,430,425,16088,6848352,5
8/27/2019,426,425,429,424,14181,6053544,-1
8/28/2019,425,424,427,424,21023,8939417,-1
8/29/2019,426,427,427,423,11405,4854431,1
9/01/2019,421,428,428,421,17893,7593805,7
9/02/2019,417,424,424,414,43531,18214197,7
9/03/2019,424,415,426,412,36698,15343752,-9
9/04/2019,426,425,429,420,22525,9586617,-1
9/05/2019,425,425,427,425,15371,6543883,0
9/08/2019,422,427,427,421,8733,3685227,5
9/09/2019,418,425,425,416,19723,8242341,7
9/10/2019,418,416,419,416,21628,9039366,-2
9/11/2019,418,417,420,416,22008,9201997,-1
9/12/2019,416,418,420,416,27640,11560120,2
9/15/2019,413,415,418,413,18691,7745284,2
9/16/2019,408,413,414,408,23477,9632318,5
9/17/2019,418,410,418,410,22549,9341043,-8
9/18/2019,423,420,423,419,28150,11843459,-3
9/19/2019,419,425,425,419,11420,4808885,6
9/22/2019,414,413,415,412,14749,6101767,-1
9/23/2019,414,413,415,412,17256,7132414,-1
9/24/2019,412,411,412,410,8687,3571384,-1
9/25/2019,412,407,412,407,11862,4876169,-5
9/26/2019,410,412,412,409,13312,5460769,2
9/29/2019,418,410,418,407,23666,9660085,-8
9/30/2019,415,412,415,411,9318,3850246,-3
10/01/2019,417,412,418,412,11045,4591929,-5
10/02/2019,411,417,417,411,3711,1533696,6
10/03/2019,416,415,418,415,3319,1382343,-1
10/10/2019,415,413,415,412,1419,588663,-2
10/14/2019,410,415,415,409,15531,6379450,5
10/15/2019,413,412,416,410,34190,14041612,-1
10/20/2019,413,412,414,411,11108,4588978,-1
10/21/2019,412,412,415,411,13609,5614798,0
10/22/2019,411,411,413,409,7228,2965213,0
10/23/2019,413,415,416,411,2992,1233519,2
10/24/2019,414,415,416,412,9027,3743021,1
10/31/2019,413,411,417,410,4949,2045232,-2
11/03/2019,412,412,413,410,4909,2018398,0
11/04/2019,413,414,414,410,13907,5720752,1
11/05/2019,416,415,416,413,12478,5166249,-1
11/06/2019,415,415,417,415,16754,6966192,0
11/07/2019,415,417,417,414,18305,7596806,2
11/10/2019,419,414,419,410,11958,4968204,-5
11/11/2019,421,414,421,414,3581,1494243,-7
11/12/2019,417,425,425,417,12550,5243574,8
11/13/2019,416,414,417,413,23563,9781256,-2
11/14/2019,417,417,417,415,18775,7799457,0
